"","Name","K","Kin","Kout","TypeI","TypeII","logFC"
"1","LEP",2,0,2,2,0,2.60066041506543
"2","TREM1",1,0,1,1,0,1.20313293958105
"3","BHLHE40",2,0,2,2,0,0.992388178566689
"4","ENG",5,0,5,2,0,0.924580712874763
"5","PVRL4",1,0,1,2,0,0.91640530280627
"6","NDRG1",1,0,1,1,0,0.758350867685843
"7","PROCR",1,0,1,1,0,0.750197678453929
"8","LIMD1",1,0,1,1,0,0.746921125317408
"9","FLNB",5,3,2,0,1,0.624931479020496
"10","SH3PXD2A",1,0,1,1,0,0.596391832031959
"11","OLFML3",1,0,1,1,0,0.567552327656118
"12","HTRA1",10,1,9,0,1,0.558276292967653
"13","LYN",37,17,20,0,1,0.539292704089943
"14","MMP1",6,4,2,0,1,0.532558083368401
"15","PIK3CB",9,6,3,0,1,0.532380877645334
"16","KIT",20,6,14,0,1,0.523934128589503
"17","IL1R2",4,0,4,2,0,0.520234688212718
"18","NTRK2",4,0,4,2,0,0.498498965206636
"19","LTF",1,0,1,1,0,0.498276030222295
"20","OPRK1",2,0,2,2,0,0.49337915620383
"21","FABP4",1,0,1,1,0,0.487222312256383
"22","GAPDH",22,6,16,0,1,0.479700892537172
"23","PRG2",1,0,1,1,0,0.467813290075652
"24","PHYHIP",7,3,4,0,1,0.467740325518907
"25","AQP1",2,0,2,1,0,0.46556713579221
"26","FN1",26,15,11,0,1,0.463873102493844
"27","TRIM24",12,8,4,0,1,0.463730786889288
"28","CEBPA",13,4,9,0,1,0.461978149299634
"29","PTPRD",3,0,3,2,0,0.455872112805556
"30","IGF1",7,5,2,0,1,0.45248132371807
"31","IL8",3,2,1,0,1,0.447743906861882
"32","IL1RAP",7,3,4,0,1,0.428065052779557
"33","VCAM1",3,1,2,0,1,0.42515480652737
"34","DLX5",1,0,1,1,0,0.422046811612423
"35","SLC1A6",2,0,2,1,0,0.405530575884253
"36","DDR1",3,1,2,0,1,0.398312950144586
"37","CALM1",47,24,23,0,1,0.393329768090421
"38","MME",6,0,6,2,0,0.389828042339312
"39","STC2",2,0,2,2,0,0.386289812436763
"40","SERPINE1",1,0,1,1,0,0.382892714950273
"41","GABRB1",1,0,1,2,0,0.38159308601642
"42","TUBA4A",11,4,7,0,1,0.380095996466123
"43","PRKD3",1,0,1,1,0,0.375449757514371
"44","COL1A2",16,5,11,0,1,0.373525091451965
"45","TLR7",2,0,2,2,0,0.369373717319562
"46","EPHB6",4,0,4,2,0,0.368174925260402
"47","GADD45G",17,9,8,0,1,0.367378867930038
"48","CYBB",1,0,1,1,0,0.365905035387353
"49","EFNA1",4,2,2,0,1,0.356355719493077
"50","RASGRF2",1,0,1,2,0,0.354393283999847
"51","GLUL",2,0,2,1,0,0.354101968167871
"52","PPL",4,1,3,0,1,0.35338024469643
"53","C10orf10",2,0,2,1,0,0.351813400728608
"54","CHN1",3,0,3,1,0,0.350187405717715
"55","S100A6",2,1,1,0,1,0.347478186041576
"56","EZR",25,12,13,0,1,0.345694462096084
"57","CCBP2",5,0,5,2,0,0.342947634609033
"58","NRCAM",3,1,2,0,1,0.342516614393066
"59","PITX2",1,0,1,1,0,0.340387219424538
"60","PIK3R1",54,27,27,0,1,0.340363758716897
"61","UGP2",1,0,1,1,0,0.336866845824593
"62","KRT17",2,0,2,2,0,0.33450706345001
"63","CCDC113",1,0,1,1,0,0.33375352776895
"64","MYCN",1,0,1,1,0,0.333654452596454
"65","PFKP",1,0,1,1,0,0.332250434333343
"66","AIF1",1,0,1,2,0,0.330382875600042
"67","BAD",22,10,12,0,1,0.32780072119829
"68","IL2RB",7,0,7,2,0,0.325382453088382
"69","CD28",9,0,9,2,0,0.321119943981335
"70","DNAJC3",3,0,3,2,0,0.320712392787668
"71","ADORA2A",4,0,4,2,0,0.320608505296681
"72","TGFBR3",2,0,2,2,0,0.319391933800745
"73","MAP3K8",5,4,1,0,1,0.31864247413149
"74","ITGA5",11,0,11,2,0,0.316321542798782
"75","PRKAR1A",6,3,3,0,1,0.31602335380571
"76","AGTR1",6,0,6,2,0,0.31540065483472
"77","NT5E",1,0,1,1,0,0.315375274548627
"78","LPL",6,3,3,0,1,0.311569787734573
"79","FBLN5",1,0,1,1,0,0.311437046710854
"80","PODXL",1,0,1,1,0,0.306956938574244
"81","FXYD3",1,0,1,1,0,0.306805775734702
"82","SLC2A1",4,2,2,0,1,0.303919303334455
"83","TXK",2,0,2,2,0,0.30145813761926
"84","GNA14",1,0,1,1,0,0.299226585169166
"85","EPHB3",2,0,2,1,0,0.298858777057448
"86","PRKCA",56,19,37,0,1,0.298265583588213
"87","JUP",14,7,7,0,1,0.297333479389271
"88","CABLES1",1,0,1,1,0,0.297081780150206
"89","PDGFRA",8,0,8,2,0,0.296942843089376
"90","ARPC5",1,0,1,1,0,0.296716117832746
"91","DNAJC1",2,0,2,1,0,0.296658071893303
"92","TRAF3",17,7,10,0,1,0.296426706065405
"93","PDK1",1,0,1,1,0,0.296076190642864
"94","P2RY2",5,0,5,2,0,0.295135091452829
"95","RUNX1T1",13,5,8,0,1,0.293632597606412
"96","PIP5K1B",1,0,1,1,0,0.290048503522396
"97","MMP14",9,1,8,0,1,0.286214143331541
"98","RHOB",1,0,1,1,0,0.285297372507534
"99","A2M",12,5,7,0,1,0.282878363005556
"100","NCOA2",12,5,7,0,1,0.281913609044775
"101","CD53",3,0,3,2,0,0.281703005787143
"102","COL1A1",20,8,12,0,1,0.281597740535414
"103","BMPR2",8,3,5,0,1,0.279836707343607
"104","PRKCZ",28,12,16,0,1,0.279255589942395
"105","APBB2",1,0,1,1,0,0.278718072641304
"106","IGFBP4",3,0,3,2,0,0.277781684902443
"107","F11R",5,0,5,2,0,0.275878361340926
"108","FCER1G",7,1,6,0,1,0.273959660922042
"109","SEPT3",1,0,1,2,0,0.271967127286938
"110","CD4",20,9,11,0,1,0.271563176057879
"111","MAF",3,2,1,0,1,0.26989260575845
"112","VIM",48,28,20,0,1,0.269843179296082
"113","F2RL1",2,0,2,2,0,0.269197811357054
"114","DARC",1,0,1,2,0,0.268559436659874
"115","CD9",7,3,4,0,1,0.268129679855951
"116","CSNK2A2",31,18,13,0,1,0.267923269869758
"117","NSMAF",2,0,2,1,0,0.262463451705834
"118","CCK",1,0,1,2,0,0.261871153006874
"119","ITPR3",2,0,2,2,0,0.260125408624496
"120","STX7",2,0,2,1,0,0.259773833127518
"121","TRPC6",3,1,2,0,1,0.259425219439823
"122","EPB41L2",6,2,4,0,1,0.259193429344327
"123","FAP",1,0,1,2,0,0.25878752655592
"124","IQGAP2",2,0,2,1,0,0.258459524334004
"125","C3AR1",1,0,1,2,0,0.257500103058332
"126","ESRRG",1,0,1,1,0,0.256811589375614
"127","IL27RA",1,0,1,2,0,0.253556655128965
"128","ITPR1",15,5,10,0,1,0.253103703661893
"129","USP9X",2,0,2,2,0,0.250194133016263
"130","SOX6",2,1,1,0,1,0.247988972612089
"131","APBA1",5,0,5,2,0,0.247121873943706
"132","GRASP",1,0,1,2,0,0.246646265581712
"133","DLK1",1,0,1,1,0,0.246116996491848
"134","DDR2",4,0,4,2,0,0.245620661550733
"135","SPI1",13,8,5,0,1,0.245544587811455
"136","UBB",21,11,10,0,1,0.245110372416386
"137","CEBPG",10,6,4,0,1,0.24196393191203
"138","TLR8",2,0,2,2,0,0.238804962664899
"139","STX1A",21,12,9,0,1,0.238735472263355
"140","MEIS1",17,9,8,0,1,0.237869567956119
"141","BMP4",4,2,2,0,1,0.237576430893141
"142","EPHA3",3,0,3,2,0,0.236547657555065
"143","FLI1",7,4,3,0,1,0.234777391107448
"144","TCF7L2",1,0,1,1,0,0.233306227196845
"145","ARHGAP9",1,0,1,1,0,0.233205963409821
"146","MAPK8",20,17,3,0,1,0.231956395405594
"147","ACTG1",15,3,12,0,1,0.231930109262574
"148","FKBP8",1,0,1,1,0,0.23178459840457
"149","TM4SF1",4,0,4,2,0,0.231376092345002
"150","TNFRSF10D",1,0,1,2,0,0.230599320730838
"151","CXCR4",12,4,8,0,1,0.23042933979233
"152","NCOR2",35,20,15,0,1,0.230382459668235
"153","ATP1B1",5,3,2,0,1,0.230283828837365
"154","FURIN",5,0,5,2,0,0.229868916302694
"155","TSPAN3",1,0,1,1,0,0.228897380237633
"156","TSC22D1",4,2,2,0,1,0.228386831247418
"157","PTGDS",5,2,3,0,1,0.227832261204735
"158","HTR1F",1,0,1,1,0,0.227380313083035
"159","ELMO1",1,0,1,1,0,0.22733591440298
"160","CTSK",3,0,3,2,0,0.226783532555109
"161","LDLR",3,0,3,2,0,0.226307777212572
"162","PTPRU",3,0,3,2,0,0.225908692370764
"163","NCF4",6,5,1,0,1,0.225297661767467
"164","IRF7",3,0,3,2,0,0.224928562250133
"165","HHEX",2,0,2,2,0,0.224923479041876
"166","KITLG",1,0,1,2,0,0.22436923337362
"167","TSPAN6",2,0,2,2,0,0.22339831990165
"168","PRDX3",1,0,1,1,0,0.222358222098851
"169","STON2",1,0,1,1,0,0.221697152539785
"170","NID1",8,6,2,0,1,0.221274151582794
"171","LPHN2",2,0,2,2,0,0.219492605359809
"172","TYROBP",5,3,2,0,1,0.219044176561251
"173","PRKCE",16,5,11,0,1,0.218519317166564
"174","ANTXR1",1,0,1,1,0,0.21804008716494
"175","C5",2,0,2,2,0,0.217768211589312
"176","RPS6KA6",9,6,3,0,1,0.217568006687777
"177","VAV1",27,18,9,0,1,0.216267208929387
"178","CNR1",1,0,1,1,0,0.21612829261375
"179","HK1",3,2,1,0,1,0.214952445298207
"180","BNIP3L",2,0,2,2,0,0.214110367097378
"181","KLF6",3,0,3,2,0,0.2132965452333
"182","BIN1",10,7,3,0,1,0.21324156061663
"183","CRKL",26,10,16,0,1,0.212965289313006
"184","TGFB3",1,0,1,2,0,0.212520794689565
"185","EEF1A1",43,19,24,0,1,0.212155297708534
"186","RIN2",1,0,1,1,0,0.211562514232838
"187","SFN",19,14,5,0,1,0.211231266890424
"188","TJP1",11,2,9,0,1,0.211120135281474
"189","PTPRR",1,0,1,1,0,0.210960934389881
"190","NUDT18",12,8,4,0,1,0.210638366283942
"191","EPHA1",2,0,2,2,0,0.210392297868793
"192","FZD7",2,0,2,2,0,0.210114253344313
"193","GATA1",9,4,5,0,1,0.209266204978134
"194","ITGB6",2,0,2,1,0,0.207931282479962
"195","CALCRL",1,0,1,2,0,0.207706616481786
"196","DUSP4",2,0,2,1,0,0.207704814045377
"197","HSPG2",8,5,3,0,1,0.207628671294056
"198","SYTL2",2,0,2,1,0,0.206860136299793
"199","TSPAN15",1,0,1,1,0,0.206728372619398
"200","LINGO1",2,0,2,2,0,0.205505708790771
"201","MYLK",14,11,3,0,1,0.205010654818487
"202","PLCB2",2,0,2,2,0,0.205006462141591
"203","PBX1",8,2,6,0,1,0.204555282115718
"204","ARHGDIB",6,0,6,2,0,0.200993714688805
"205","VAV3",9,3,6,0,1,0.199731095098516
"206","PTGER2",2,0,2,2,0,0.198463245310609
"207","TNFRSF13B",4,0,4,2,0,0.197608066885365
"208","TNFRSF11A",6,0,6,2,0,0.197409281414371
"209","CLIC4",1,0,1,1,0,0.196666026946227
"210","CLTC",19,10,9,0,1,0.196565760990937
"211","OBSCN",1,0,1,1,0,0.196239874864158
"212","ACVRL1",3,0,3,2,0,0.196186266090624
"213","GMEB2",2,0,2,1,0,0.196061669836093
"214","KRT15",15,14,1,0,1,0.195137296766277
"215","SYT1",3,1,2,0,1,0.194602457686009
"216","CAV1",49,24,25,0,1,0.194208622935694
"217","MAPK8IP3",16,5,11,0,1,0.194113838042023
"218","AMFR",3,0,3,2,0,0.193820237754659
"219","PGD",1,0,1,1,0,0.192319865317735
"220","TRAK2",1,0,1,1,0,0.192296204331617
"221","LPAR1",1,0,1,1,0,0.191201589503859
"222","THBS1",21,10,11,0,1,0.190420389005128
"223","PRKG1",14,6,8,0,1,0.189521577704183
"224","EXPH5",1,0,1,1,0,0.189205202180331
"225","PARD3",8,3,5,0,1,0.188847035416131
"226","STAM",3,0,3,1,0,0.18828950710537
"227","HCK",35,25,10,0,1,0.188161187363848
"228","TFAP2A",3,0,3,2,0,0.188008302075907
"229","PIK3CG",9,7,2,0,1,0.187550591798392
"230","PRKD1",12,9,3,0,1,0.187446219047373
"231","CAMP",2,0,2,2,0,0.187414004978273
"232","TUBA1A",20,6,14,0,1,0.186768971024508
"233","ATP5A1",3,0,3,1,0,0.186456688027244
"234","ITGA9",1,0,1,1,0,0.186354648254966
"235","EGFR",68,32,36,0,1,0.186196258417574
"236","CCNE2",2,0,2,1,0,0.185027064949608
"237","DYNLL1",16,11,5,0,1,0.184880786418406
"238","ARMCX3",1,0,1,1,0,0.183758867842577
"239","GABARAPL2",7,6,1,0,1,0.182024894645814
"240","NFE2L2",8,4,4,0,1,0.181843480376815
"241","SLC9A3R2",14,7,7,0,1,0.181704284068479
"242","PTK2B",28,10,18,0,1,0.181326121787157
"243","TNIP1",3,0,3,2,0,0.180454244913667
"244","PLCG2",25,16,9,0,1,0.179952046189955
"245","COL3A1",7,4,3,0,1,0.179576172335135
"246","GIGYF1",1,0,1,1,0,0.177665768782672
"247","PRLR",6,0,6,2,0,0.176907122053022
"248","SNTB1",2,0,2,2,0,0.176714661133525
"249","BICD2",2,0,2,1,0,0.176507143212534
"250","PPP2R5A",10,6,4,0,1,0.175731396590985
"251","ANGPTL1",1,0,1,1,0,0.175678562304117
"252","TFDP1",7,5,2,0,1,0.175374522327127
"253","MEF2C",7,3,4,0,1,0.174682771681006
"254","OSMR",1,0,1,1,0,0.174320751727576
"255","FNBP4",2,0,2,1,0,0.174278276712478
"256","TLR3",1,0,1,1,0,0.17366565093525
"257","IL6R",1,0,1,1,0,0.172476355679195
"258","POMC",2,0,2,1,0,0.171793038860503
"259","PRSS23",9,3,6,0,1,0.171594272887381
"260","TFDP2",3,2,1,0,1,0.171162160531194
"261","PTPRB",6,3,3,0,1,0.170927601135675
"262","CABP2",1,0,1,2,0,0.170920989681821
"263","PCSK6",1,0,1,1,0,0.170712523811672
"264","GABRR1",1,0,1,1,0,0.170070555998403
"265","ERBB3",12,0,12,2,0,0.169164628468979
"266","CLEC5A",1,0,1,1,0,0.168972288071561
"267","TRAF2",65,12,53,0,1,0.168693157699431
"268","NOTCH3",7,0,7,2,0,0.168356480596408
"269","BTK",38,3,35,0,1,0.168306093944167
"270","ITGAM",6,0,6,2,0,0.168147313811728
"271","LIMS1",1,0,1,2,0,0.16804326791037
"272","ADRA2C",3,0,3,2,0,0.167843053740746
"273","NPY1R",1,0,1,2,0,0.167167565188204
"274","SAV1",1,0,1,1,0,0.166834147627373
"275","CD63",2,0,2,2,0,0.16666375647007
"276","MS4A7",1,0,1,2,0,0.166652872586742
"277","TNIP2",5,3,2,0,1,0.166355340994453
"278","HMGB1",28,23,5,0,1,0.164988853430959
"279","SKIL",16,0,16,2,0,0.164651931873259
"280","SOX5",3,2,1,0,1,0.16458072610213
"281","SSTR1",2,0,2,2,0,0.163898062400132
"282","TES",5,2,3,0,1,0.163677634165662
"283","MAPK11",3,2,1,0,1,0.163413967425151
"284","LIN7B",4,2,2,0,1,0.163176721256749
"285","VASP",14,12,2,0,1,0.162805712519873
"286","AHNAK",1,0,1,1,0,0.1626386696362
"287","EPHB4",1,0,1,2,0,0.162315515350549
"288","PLA2G4A",8,4,4,0,1,0.16108517332069
"289","PARVG",1,0,1,1,0,0.160833869001698
"290","CDKN1A",31,22,9,0,1,0.160526425700269
"291","WNT1",3,2,1,0,1,0.160471857120857
"292","IPO8",1,0,1,1,0,0.160158370016466
"293","MTA1",2,0,2,1,0,0.160028704113456
"294","PHPT1",1,0,1,1,0,0.158367009698756
"295","CAT",1,0,1,1,0,0.158049145941918
"296","TACC1",1,0,1,1,0,0.15791804803607
"297","SERPING1",4,1,3,0,1,0.157359385060555
"298","SMAD6",7,3,4,0,1,0.157274147505071
"299","CLOCK",1,0,1,2,0,0.156996217238747
"300","TNFRSF25",4,0,4,1,0,0.156958176866384
"301","TFCP2",1,0,1,1,0,0.156743538452815
"302","NOTCH4",4,0,4,2,0,0.156514974820251
"303","EDNRB",5,0,5,2,0,0.15651459192585
"304","FGFR4",9,0,9,2,0,0.15606919610494
"305","GAST",2,0,2,2,0,0.155879751589925
"306","PAK2",8,5,3,0,1,0.155874930971283
"307","TYRO3",4,0,4,2,0,0.155331702374248
"308","MYO5A",5,3,2,0,1,0.154806734647232
"309","PCM1",4,1,3,0,1,0.154678790468239
"310","SLC22A4",1,0,1,1,0,0.154561133926256
"311","MRPL44",8,5,3,0,1,0.153822754995994
"312","F3",2,0,2,1,0,0.153472705772902
"313","CTNNB1",56,36,20,0,1,0.153422975605354
"314","CSF3R",6,0,6,2,0,0.152758521445746
"315","PARP1",15,0,15,2,0,0.151818486994484
"316","CUBN",1,0,1,1,0,0.151489068343436
"317","TGFBR2",16,5,11,0,1,0.151114437868534
"318","BLOC1S2",3,2,1,0,1,0.150476079124142
"319","YWHAZ",44,10,34,0,1,0.150102647491359
"320","INHBB",5,0,5,2,0,0.150081635971145
"321","RHPN2",1,0,1,1,0,0.149980334812392
"322","KPNA2",12,10,2,0,1,0.149971786131051
"323","AIFM1",3,2,1,0,1,0.14984191547788
"324","RAB6B",1,0,1,1,0,0.149662008451889
"325","RPL8",2,0,2,1,0,0.149583848462408
"326","RCN2",1,0,1,1,0,0.149414771766066
"327","PRKAA2",2,1,1,0,1,0.14939820515542
"328","LNPEP",1,0,1,2,0,0.149189884236895
"329","HOXA11",1,0,1,1,0,0.149012927731946
"330","CASP4",5,0,5,2,0,0.148494662745431
"331","CEBPB",25,6,19,0,1,0.14830990435525
"332","OSGEP",9,3,6,0,1,0.14829611490776
"333","CGN",2,1,1,0,1,0.148271014359834
"334","TNFRSF10B",4,1,3,0,1,0.148213760256892
"335","SELP",4,0,4,2,0,0.148184881722127
"336","BMP1",5,0,5,2,0,0.14805282943604
"337","TRMT2A",5,0,5,1,0,0.148002748934426
"338","CCNE1",9,3,6,0,1,0.147691866869462
"339","TMEM98",1,0,1,2,0,0.147621299455673
"340","DLG2",12,0,12,2,0,0.147418675807101
"341","PLCB1",2,0,2,1,0,0.147373966933625
"342","MAEA",1,0,1,1,0,0.14716415857988
"343","TNFRSF21",2,0,2,1,0,0.146942916992517
"344","SEMA6A",1,0,1,1,0,0.14622751597099
"345","MID1IP1",2,0,2,1,0,0.145932156403542
"346","NPPB",1,0,1,1,0,0.145795456371606
"347","ITGA2",4,0,4,2,0,0.14553551114875
"348","CHMP2A",3,1,2,0,1,0.145423169388122
"349","EFEMP2",11,7,4,0,1,0.145322435613052
"350","ACTB",59,36,23,0,1,0.144863638722642
"351","TNFRSF12A",2,0,2,1,0,0.144797875757046
"352","FGF2",9,0,9,2,0,0.144563707038602
"353","HSP90AA1",28,13,15,0,1,0.144556283686887
"354","ITGB2",23,5,18,0,1,0.144458680130056
"355","PTN",11,4,7,0,1,0.144308068235411
"356","GNA15",4,0,4,2,0,0.144275195855937
"357","UBE2A",3,0,3,2,0,0.143897627464131
"358","NR1H2",7,0,7,2,0,0.143403136895412
"359","CDH1",9,4,5,0,1,0.143167500543347
"360","GRK5",7,2,5,0,1,0.143138593498625
"361","GNAQ",7,2,5,0,1,0.143101789272913
"362","HSPA8",31,12,19,0,1,0.142938599264212
"363","P2RY12",1,0,1,1,0,0.142883819021346
"364","PFKM",4,0,4,2,0,0.142789924350239
"365","GEMIN5",1,0,1,1,0,0.142611889813289
"366","ROBO1",3,0,3,2,0,0.142464658824506
"367","CDH5",8,4,4,0,1,0.142190659742832
"368","NAGK",3,0,3,1,0,0.14170960988826
"369","IL2RA",2,0,2,2,0,0.141688895553877
"370","ZNF354A",1,0,1,1,0,0.141447474331891
"371","ANK2",2,1,1,0,1,0.141424004277127
"372","PXN",40,11,29,0,1,0.141417412663561
"373","CDK9",17,7,10,0,1,0.140489207025245
"374","GOT2",4,0,4,2,0,0.140449051710828
"375","CALCR",4,2,2,0,1,0.14021914243554
"376","JAK2",18,5,13,0,1,0.139802288058336
"377","FZD8",3,0,3,2,0,0.139763489270856
"378","SORBS3",10,9,1,0,1,0.139655834500702
"379","SMURF2",17,8,9,0,1,0.139604854604446
"380","LRP2BP",1,0,1,1,0,0.139371167155447
"381","ZNF579",5,0,5,2,0,0.139220567243946
"382","PDIA4",2,0,2,1,0,0.138921587259784
"383","IMMT",14,2,12,0,1,0.1385029823767
"384","TRAF5",13,7,6,0,1,0.13843353186552
"385","TNFSF14",2,0,2,2,0,0.138334436966081
"386","RFXAP",1,0,1,2,0,0.137839344323971
"387","TLR1",6,1,5,0,1,0.137719517375401
"388","GRIN2D",17,10,7,0,1,0.137291224310331
"389","CAPN2",4,1,3,0,1,0.136606134200566
"390","CD81",8,3,5,0,1,0.136193305563179
"391","SHANK2",8,3,5,0,1,0.135959495171791
"392","YWHAB",55,33,22,0,1,0.135913962944171
"393","CFDP1",1,0,1,1,0,0.13559722256884
"394","FTL",3,0,3,2,0,0.135266531461848
"395","NEDD4",14,11,3,0,1,0.134792220863643
"396","SPOCK2",1,0,1,2,0,0.13472750577241
"397","PAX6",2,1,1,0,1,0.133963841210946
"398","XRCC5",14,8,6,0,1,0.133951412558242
"399","TIMM17A",1,0,1,1,0,0.133842667452335
"400","CALD1",2,0,2,1,0,0.133779769543009
"401","TEK",10,2,8,0,1,0.133608494106642
"402","ADRA1D",3,0,3,2,0,0.133418283862752
"403","TANK",5,3,2,0,1,0.133191810028936
"404","RBBP7",7,0,7,1,0,0.133131460271942
"405","SATB1",1,0,1,1,0,0.133052061125755
"406","AKAP8",7,4,3,0,1,0.132887204988668
"407","MAGED1",7,0,7,2,0,0.132443528403266
"408","GNAI1",17,8,9,0,1,0.132344937146405
"409","PLXNB1",4,0,4,2,0,0.131779980524952
"410","MAF1",1,0,1,1,0,0.131679018792999
"411","PLXND1",1,0,1,2,0,0.131557076896843
"412","INSR",33,9,24,0,1,0.131136885939572
"413","ARID4A",1,0,1,1,0,0.13098267040165
"414","TACR3",1,0,1,2,0,0.130380390480767
"415","NFKBIA",6,0,6,2,0,0.130287993043364
"416","TCF4",11,4,7,0,1,0.130140579971755
"417","NGFRAP1",6,0,6,2,0,0.129903633276138
"418","EPHA2",7,0,7,2,0,0.129514520785822
"419","RGS9",1,0,1,2,0,0.129365259552233
"420","EEF1G",23,4,19,0,1,0.129012871219075
"421","TLR6",3,0,3,2,0,0.128392077575479
"422","HIST3H3",18,8,10,0,1,0.128273351419965
"423","STK11",7,4,3,0,1,0.128034774364375
"424","PMEPA1",1,0,1,1,0,0.127834197782174
"425","SMAD1",26,7,19,0,1,0.127226071309906
"426","TOLLIP",9,5,4,0,1,0.127023054654842
"427","DVL2",25,11,14,0,1,0.126713697451073
"428","RASGRF1",2,0,2,1,0,0.126695076861925
"429","NF2",2,0,2,2,0,0.126546728177773
"430","TBL3",1,0,1,2,0,0.126030046835854
"431","WNT4",2,1,1,0,1,0.12583243147439
"432","OTX1",1,0,1,1,0,0.125739374428073
"433","RCOR1",3,2,1,0,1,0.125619257688124
"434","PHGDH",1,0,1,1,0,0.125591372606971
"435","SURF2",1,0,1,1,0,0.125425408951394
"436","DRD4",3,0,3,2,0,0.125241645373777
"437","DLG1",22,1,21,0,1,0.125047535093891
"438","CKAP5",1,0,1,1,0,0.124718297814212
"439","DFNB31",2,0,2,2,0,0.124373080870333
"440","MAPK1",43,29,14,0,1,0.124155525650588
"441","ARPC4",1,0,1,2,0,0.124112145264812
"442","ERP29",1,0,1,2,0,0.124051069325153
"443","PTPRE",4,0,4,2,0,0.123921113292573
"444","NR2F6",2,0,2,2,0,0.123741040886037
"445","BRCA1",48,3,45,0,1,0.12358300926916
"446","VCP",9,0,9,2,0,0.123530137221701
"447","BTC",1,0,1,1,0,0.123162105009314
"448","CCNT2",3,2,1,0,1,0.123048748141994
"449","NRP2",3,0,3,2,0,0.122749684573126
"450","BIRC2",12,3,9,0,1,0.122684526968907
"451","ARNT",16,8,8,0,1,0.12143568421293
"452","CTSD",9,5,4,0,1,0.121089329582599
"453","UFD1L",3,2,1,0,1,0.120998880294744
"454","SLC8A1",3,1,2,0,1,0.120995136665086
"455","GNB2L1",27,18,9,0,1,0.120942509081868
"456","IRF8",8,3,5,0,1,0.120740492011445
"457","ETV1",1,0,1,2,0,0.12018432137473
"458","PSPC1",1,0,1,2,0,0.120093118547329
"459","ACE2",2,0,2,2,0,0.119665478977538
"460","CAPRIN1",1,0,1,2,0,0.119283261401586
"461","PRNP",7,0,7,2,0,0.119103144484546
"462","SH3GL1",8,3,5,0,1,0.118511039423291
"463","PSMB4",1,0,1,1,0,0.118340993077746
"464","UBAP2L",3,1,2,0,1,0.118171347361029
"465","ZNF655",1,0,1,1,0,0.117640323254971
"466","HNF4A",16,4,12,0,1,0.117358670661993
"467","CREB1",15,9,6,0,1,0.117186016554792
"468","RTN4R",3,0,3,2,0,0.117138370343538
"469","SETD7",2,0,2,1,0,0.116613021279097
"470","GNB1",10,4,6,0,1,0.116203710647738
"471","COL13A1",1,0,1,1,0,0.116057139296357
"472","PTPRO",1,0,1,2,0,0.115956664615094
"473","TNFRSF19",2,0,2,1,0,0.115674446720183
"474","IFNGR1",4,0,4,2,0,0.114866533841031
"475","GIPC1",12,6,6,0,1,0.114575011667464
"476","CELSR1",1,0,1,1,0,0.113705484008687
"477","KCTD17",1,0,1,1,0,0.113584944536791
"478","TSPAN4",3,0,3,2,0,0.113395915367775
"479","CHML",1,0,1,1,0,0.113375404422233
"480","HSPBAP1",1,0,1,1,0,0.113184387592746
"481","ADAMTS4",2,0,2,1,0,0.113084578237213
"482","LLGL1",2,1,1,0,1,0.113011256531534
"483","DLG4",22,8,14,0,1,0.112792162245154
"484","ENO2",4,0,4,2,0,0.112218960723996
"485","WIPF2",1,0,1,1,0,0.111927429158452
"486","FOXA2",5,4,1,0,1,0.111501852379113
"487","PLXNA3",2,0,2,2,0,0.111250768745126
"488","TRRAP",7,5,2,0,1,0.110649713141088
"489","HAAO",1,0,1,1,0,0.110420951660613
"490","NKIRAS1",1,0,1,1,0,0.110154349233653
"491","SDCBP",13,8,5,0,1,0.109848865456607
"492","TGOLN2",2,0,2,2,0,0.109805309477897
"493","PRKCB",25,15,10,0,1,0.10948091001088
"494","DNASE1",1,0,1,1,0,0.109203122134419
"495","UBE2E3",5,4,1,0,1,0.109189716501881
"496","ATXN1",34,18,16,0,1,0.109163856154854
"497","CPNE6",3,0,3,2,0,0.108961803391805
"498","C8orf33",11,6,5,0,1,0.108604471504432
"499","TTC3",1,0,1,1,0,0.108539562583779
"500","SMAD9",8,0,8,2,0,0.10829348443819
"501","XRN1",14,10,4,0,1,0.108208152086201
"502","GTF2I",3,0,3,2,0,0.108197167852698
"503","CENPB",3,0,3,2,0,0.108037182597743
"504","ZNF426",1,0,1,1,0,0.107703495626858
"505","CTSG",5,3,2,0,1,0.106682779246531
"506","NCDN",1,0,1,1,0,0.106448614339785
"507","STRADB",1,0,1,1,0,0.106397009614373
"508","CSNK2B",53,20,33,0,1,0.106302089504954
"509","RBL1",18,17,1,0,1,0.106039194854544
"510","EAPP",1,0,1,1,0,0.105092528651548
"511","DRD1",1,0,1,2,0,0.104475206606552
"512","PSMC6",4,0,4,2,0,0.104115963238726
"513","SPTAN1",17,5,12,0,1,0.103398589114258
"514","TRAFD1",1,0,1,1,0,0.103354092828935
"515","ZNF775",2,0,2,2,0,0.103227777923362
"516","CDC42EP1",1,0,1,1,0,0.102730027178316
"517","E4F1",1,0,1,1,0,0.102444939597437
"518","VCL",36,18,18,0,1,0.102198170920005
"519","PIAS4",27,23,4,0,1,0.102171785517276
"520","SUMO2",16,13,3,0,1,0.101582618232266
"521","RDH11",1,0,1,1,0,0.101370856415054
"522","NDEL1",5,2,3,0,1,0.101237079356702
"523","NFU1",1,0,1,1,0,0.101047884968374
"524","CDK5",28,21,7,0,1,0.100934282346309
"525","MGMT",1,0,1,1,0,0.100584264418421
"526","RPLP2",1,0,1,1,0,0.100241369825392
"527","TRH",1,0,1,1,0,0.100215275571311
"528","CDH15",1,0,1,1,0,0.100075363423711
"529","BTRC",14,6,8,0,1,0.0996194703417146
"530","DNAJC7",6,4,2,0,1,0.099440502956778
"531","NAV2",1,0,1,1,0,0.0992799571291556
"532","PSEN2",10,4,6,0,1,0.098905094861081
"533","HDLBP",1,0,1,1,0,0.0988228509828062
"534","MEX3B",1,0,1,1,0,0.0987637103233183
"535","CELSR3",5,0,5,2,0,0.0985502889693173
"536","ANXA11",2,0,2,2,0,0.0980062843850291
"537","AFF1",3,1,2,0,1,0.0978871095703955
"538","ZFYVE9",11,8,3,0,1,0.0976459144246151
"539","TNFRSF13C",2,0,2,2,0,0.0972827330186874
"540","COPS6",23,10,13,0,1,0.0970185495923488
"541","CSTF2",11,7,4,0,1,0.0968772335712487
"542","TUBA1B",2,0,2,1,0,0.0966229934466796
"543","POLDIP2",4,1,3,0,1,0.0964410926233175
"544","ST3GAL3",1,0,1,1,0,0.0962874560033349
"545","ACP6",1,0,1,2,0,0.0961861980072856
"546","PSAP",5,4,1,0,1,0.0960623430742302
"547","SMARCD3",1,0,1,2,0,0.0959275357266041
"548","NFKB2",10,4,6,0,1,0.0955106068971645
"549","RABAC1",15,8,7,0,1,0.0954581573281974
"550","RHOG",6,4,2,0,1,0.0952912134029891
"551","NTRK1",14,3,11,0,1,0.0952050820097279
"552","HGS",23,10,13,0,1,0.0947510181516513
"553","CD27",1,0,1,1,0,0.0939135475399979
"554","ING2",2,0,2,1,0,0.0938458928453993
"555","PPM1B",1,0,1,1,0,0.0937465717621837
"556","GSK3B",38,11,27,0,1,0.0936401570273535
"557","SNRPC",1,0,1,1,0,0.0930746598027934
"558","KLC2",1,0,1,1,0,0.0921990717945738
"559","UPF3B",4,0,4,2,0,0.0919506048052519
"560","PPP2CA",18,8,10,0,1,0.0919048090581569
"561","TRIM2",2,1,1,0,1,0.0915894313357217
"562","TNNI1",2,0,2,1,0,0.0915786116466855
"563","SUCLG2",1,0,1,2,0,0.090937980477948
"564","LSM7",2,1,1,0,1,0.0906810093056318
"565","BAX",7,0,7,2,0,0.0900873262780841
"566","MAP2K6",9,5,4,0,1,0.0900055534870923
"567","NFKBIB",12,6,6,0,1,0.0893843938194578
"568","CFL1",10,5,5,0,1,0.0893018199817046
"569","PSMB7",1,0,1,1,0,0.0891908368467202
"570","NEK1",10,8,2,0,1,0.0887779744721255
"571","CNOT2",1,0,1,2,0,0.0884615840029479
"572","POLR2G",1,0,1,1,0,0.0881757892305739
"573","CD55",1,0,1,1,0,0.0880487285855143
"574","CAP1",1,0,1,1,0,0.0869799772068109
"575","CBFB",1,0,1,2,0,0.0862172575580296
"576","DMD",8,4,4,0,1,0.086134932504331
"577","DALRD3",1,0,1,1,0,0.0860888406273457
"578","LUC7L2",20,10,10,0,1,0.0857959827528809
"579","NLRC4",1,0,1,2,0,0.0856500805498932
"580","TFE3",2,0,2,2,0,0.0856008344452199
"581","TRADD",15,8,7,0,1,0.0843738315945188
"582","SOX10",13,5,8,0,1,0.0835983360654096
"583","CLTA",1,0,1,1,0,0.0835757043369885
"584","KCNQ1",1,0,1,1,0,0.0823370412414075
"585","SETDB1",42,31,11,0,1,0.0821959351722157
"586","RHOA",23,11,12,0,1,0.0815970582818402
"587","SMARCA4",16,8,8,0,1,0.081519525489723
"588","SSBP4",1,0,1,1,0,0.0813925517265073
"589","PEA15",4,0,4,2,0,0.0809429255627734
"590","PHF10",1,0,1,1,0,0.0804360399234056
"591","HDAC3",28,20,8,0,1,0.0803911289545756
"592","ONECUT1",1,0,1,1,0,0.0802942022297612
"593","C8orf48",1,0,1,1,0,0.0792417629999553
"594","TALDO1",1,0,1,1,0,0.0792299398497605
"595","RPA2",14,7,7,0,1,0.079208752043864
"596","IDH3A",1,0,1,2,0,0.0790132302508155
"597","MAPK12",8,5,3,0,1,0.078797358928469
"598","CNTNAP1",1,0,1,1,0,0.0787625273323709
"599","PRKCD",30,15,15,0,1,0.0787610216637837
"600","UCN",2,1,1,0,1,0.0787447793105223
"601","DAP3",1,0,1,1,0,0.07858681949239
"602","MAPK1IP1L",1,0,1,1,0,0.0782856254310449
"603","SHC1",60,30,30,0,1,0.0774397423870798
"604","SAAL1",1,0,1,1,0,0.0772582026626214
"605","RAE1",1,0,1,2,0,0.0771270551648371
"606","NES",1,0,1,1,0,0.0769590690568531
"607","RAB31",1,0,1,1,0,0.07639916648675
"608","PURB",1,0,1,2,0,0.0763972078066093
"609","NUP153",1,0,1,1,0,0.0757210586301351
"610","DAZAP2",15,8,7,0,1,0.0757128262742288
"611","TUBG1",9,5,4,0,1,0.0756512175635571
"612","NRD1",2,1,1,0,1,0.0748646605241632
"613","DCTN2",2,0,2,1,0,0.0741654863652474
"614","E2F6",1,0,1,1,0,0.0727104936765173
"615","PIP4K2B",1,0,1,2,0,0.0726616395751609
"616","UBE2W",1,0,1,1,0,0.0720086805537612
"617","IARS",2,1,1,0,1,0.0715101321222065
"618","THAP1",1,0,1,1,0,0.0713935445928602
"619","PEX5",3,0,3,2,0,0.0707363274297403
"620","NFYC",1,0,1,2,0,0.0706589198590617
"621","ARF1",22,6,16,0,1,0.0699903926717464
"622","ZBTB5",1,0,1,1,0,0.0693272502196445
"623","RAB5B",1,0,1,2,0,0.0689821246124751
"624","HDAC6",10,8,2,0,1,0.0685441699552136
"625","EIF2AK1",1,0,1,1,0,0.0671026074656531
"626","SMARCC1",4,1,3,0,1,0.0665962573700138
"627","EIF2B1",2,1,1,0,1,0.066565726257144
"628","TBP",33,12,21,0,1,0.0652774753291894
"629","MMS19",1,0,1,1,0,0.0638450615647308
"630","PPP2R1A",10,7,3,0,1,0.0606062606502551
"631","DNPEP",2,0,2,1,0,0.0583783307623396
"632","ABCF3",4,3,1,0,1,NA
"633","ABL1",28,15,13,0,1,NA
"634","ACTN1",21,12,9,0,1,NA
"635","ACTN4",10,7,3,0,1,NA
"636","ACVR1",27,12,15,0,1,NA
"637","ACVR2A",4,3,1,0,1,NA
"638","ADRA2A",5,2,3,0,1,NA
"639","AIP",3,2,1,0,1,NA
"640","AKAP10",6,3,3,0,1,NA
"641","AKAP9",12,9,3,0,1,NA
"642","AMPH",3,1,2,0,1,NA
"643","ANXA7",51,33,18,0,1,NA
"644","AP1M1",10,2,8,0,1,NA
"645","AP2A1",12,7,5,0,1,NA
"646","AP2M1",7,5,2,0,1,NA
"647","AP3B1",6,2,4,0,1,NA
"648","APOA1",5,2,3,0,1,NA
"649","APP",33,14,19,0,1,NA
"650","APPL1",5,1,4,0,1,NA
"651","AR",26,7,19,0,1,NA
"652","ARHGDIA",13,12,1,0,1,NA
"653","ARHGEF11",6,3,3,0,1,NA
"654","ARHGEF15",2,1,1,0,1,NA
"655","ARPC3",5,2,3,0,1,NA
"656","ARRB1",13,5,8,0,1,NA
"657","ASCC2",15,10,5,0,1,NA
"658","ATF7IP",18,8,10,0,1,NA
"659","ATN1",45,19,26,0,1,NA
"660","ATP5C1",8,6,2,0,1,NA
"661","AURKA",8,3,5,0,1,NA
"662","AXL",12,1,11,0,1,NA
"663","B2M",5,2,3,0,1,NA
"664","BAG1",7,4,3,0,1,NA
"665","BCAR1",25,18,7,0,1,NA
"666","BCL2L1",17,13,4,0,1,NA
"667","BCR",16,10,6,0,1,NA
"668","BID",15,9,6,0,1,NA
"669","BUB1B",3,1,2,0,1,NA
"670","C2orf44",6,2,4,0,1,NA
"671","C3",4,3,1,0,1,NA
"672","C7orf25",5,3,2,0,1,NA
"673","CACNA1A",3,2,1,0,1,NA
"674","CALCA",2,1,1,0,1,NA
"675","CALCOCO2",12,5,7,0,1,NA
"676","CAMK2A",12,9,3,0,1,NA
"677","CAPNS1",6,2,4,0,1,NA
"678","CASP3",55,21,34,0,1,NA
"679","CASP7",13,9,4,0,1,NA
"680","CASP8",29,8,21,0,1,NA
"681","CBL",34,18,16,0,1,NA
"682","CCDC85B",63,49,14,0,1,NA
"683","CCDC90B",11,8,3,0,1,NA
"684","CCL21",5,3,2,0,1,NA
"685","CCL22",3,2,1,0,1,NA
"686","CCR1",9,6,3,0,1,NA
"687","CCR5",8,5,3,0,1,NA
"688","CD2",10,8,2,0,1,NA
"689","CD244",2,1,1,0,1,NA
"690","CD247",13,2,11,0,1,NA
"691","CD3E",8,4,4,0,1,NA
"692","CD44",21,8,13,0,1,NA
"693","CD48",5,2,3,0,1,NA
"694","CDC25C",10,6,4,0,1,NA
"695","CDC34",8,6,2,0,1,NA
"696","CDK5RAP2",9,6,3,0,1,NA
"697","CEBPE",9,5,4,0,1,NA
"698","CHD3",37,23,14,0,1,NA
"699","CHRNA4",3,1,2,0,1,NA
"700","CHUK",32,21,11,0,1,NA
"701","CIB1",6,3,3,0,1,NA
"702","CNKSR1",5,3,2,0,1,NA
"703","COIL",20,15,5,0,1,NA
"704","COL2A1",10,6,4,0,1,NA
"705","COPB1",9,4,5,0,1,NA
"706","CPE",6,3,3,0,1,NA
"707","CPNE2",4,3,1,0,1,NA
"708","CREB3",3,1,2,0,1,NA
"709","CREBBP",80,35,45,0,1,NA
"710","CSK",16,10,6,0,1,NA
"711","CSNK1A1",12,7,5,0,1,NA
"712","CSNK2A1",49,36,13,0,1,NA
"713","CTGF",5,3,2,0,1,NA
"714","CTNND2",3,1,2,0,1,NA
"715","CXCL13",5,4,1,0,1,NA
"716","DCTN1",12,8,4,0,1,NA
"717","DDIT3",5,3,2,0,1,NA
"718","DIABLO",4,1,3,0,1,NA
"719","DISC1",4,2,2,0,1,NA
"720","DLG3",9,1,8,0,1,NA
"721","DLST",5,3,2,0,1,NA
"722","DOK1",10,3,7,0,1,NA
"723","DPYSL2",3,2,1,0,1,NA
"724","DRAP1",6,2,4,0,1,NA
"725","DUSP10",4,1,3,0,1,NA
"726","DUSP23",8,3,5,0,1,NA
"727","DVL3",18,13,5,0,1,NA
"728","E2F2",5,2,3,0,1,NA
"729","E2F3",9,4,5,0,1,NA
"730","EFNB2",8,3,5,0,1,NA
"731","EIF2S2",10,4,6,0,1,NA
"732","EIF3E",6,1,5,0,1,NA
"733","EIF4EBP1",11,7,4,0,1,NA
"734","EP300",84,71,13,0,1,NA
"735","EPB41",12,4,8,0,1,NA
"736","EPS8",10,4,6,0,1,NA
"737","ERBB2",25,4,21,0,1,NA
"738","ERCC3",9,6,3,0,1,NA
"739","EWSR1",35,16,19,0,1,NA
"740","EXOSC6",13,2,11,0,1,NA
"741","EZH2",9,1,8,0,1,NA
"742","F10",5,2,3,0,1,NA
"743","F2",7,1,6,0,1,NA
"744","FADD",17,7,10,0,1,NA
"745","FAM118B",10,6,4,0,1,NA
"746","FGFR3",12,8,4,0,1,NA
"747","FLNA",17,10,7,0,1,NA
"748","FLT3LG",2,1,1,0,1,NA
"749","FRS3",6,3,3,0,1,NA
"750","FXR2",16,9,7,0,1,NA
"751","FYN",67,31,36,0,1,NA
"752","FZD9",3,1,2,0,1,NA
"753","GABARAP",3,2,1,0,1,NA
"754","GADD45A",20,12,8,0,1,NA
"755","GATA4",2,1,1,0,1,NA
"756","GIT1",27,14,13,0,1,NA
"757","GNA12",6,1,5,0,1,NA
"758","GNA13",16,6,10,0,1,NA
"759","GNAI2",31,21,10,0,1,NA
"760","GNAI3",17,4,13,0,1,NA
"761","GNAO1",5,2,3,0,1,NA
"762","GNAZ",6,4,2,0,1,NA
"763","GPRASP1",8,2,6,0,1,NA
"764","GPS1",9,4,5,0,1,NA
"765","GPS2",6,3,3,0,1,NA
"766","GRB2",78,41,37,0,1,NA
"767","GRIA4",4,3,1,0,1,NA
"768","GRID2",3,1,2,0,1,NA
"769","GRM5",11,1,10,0,1,NA
"770","GTF2E2",16,9,7,0,1,NA
"771","GTF2F1",12,8,4,0,1,NA
"772","GTF3C1",9,7,2,0,1,NA
"773","GZMB",5,1,4,0,1,NA
"774","H2AFX",10,5,5,0,1,NA
"775","HAP1",26,21,5,0,1,NA
"776","HBEGF",6,2,4,0,1,NA
"777","HDAC1",50,41,9,0,1,NA
"778","HDAC4",15,12,3,0,1,NA
"779","HIPK3",6,3,3,0,1,NA
"780","HMOX2",7,3,4,0,1,NA
"781","HMP19",5,1,4,0,1,NA
"782","HNF1A",8,4,4,0,1,NA
"783","HOMER1",10,4,6,0,1,NA
"784","HOXC8",4,2,2,0,1,NA
"785","HRAS",28,20,8,0,1,NA
"786","HSPA1A",15,13,2,0,1,NA
"787","HSPA5",9,2,7,0,1,NA
"788","HTR1D",2,1,1,0,1,NA
"789","HTT",28,16,12,0,1,NA
"790","ICAM1",10,6,4,0,1,NA
"791","ID2",18,9,9,0,1,NA
"792","IGF1R",16,7,9,0,1,NA
"793","IKBKAP",11,7,4,0,1,NA
"794","IKBKB",18,13,5,0,1,NA
"795","IL18",4,2,2,0,1,NA
"796","IL2RG",8,6,2,0,1,NA
"797","IL4R",7,1,6,0,1,NA
"798","ILK",10,8,2,0,1,NA
"799","IRAK1",25,7,18,0,1,NA
"800","IRS1",20,14,6,0,1,NA
"801","ITCH",5,2,3,0,1,NA
"802","ITFG1",4,2,2,0,1,NA
"803","ITGA3",6,2,4,0,1,NA
"804","ITGAV",8,4,4,0,1,NA
"805","ITGB3BP",5,3,2,0,1,NA
"806","JAK1",31,12,19,0,1,NA
"807","JAK3",8,4,4,0,1,NA
"808","JUN",46,19,27,0,1,NA
"809","KAT2A",14,11,3,0,1,NA
"810","KIAA1279",3,1,2,0,1,NA
"811","KIAA1377",22,11,11,0,1,NA
"812","KPNB1",15,8,7,0,1,NA
"813","KRT18",10,5,5,0,1,NA
"814","LCK",40,18,22,0,1,NA
"815","LMO2",4,2,2,0,1,NA
"816","LMO4",9,7,2,0,1,NA
"817","LRP1",15,8,7,0,1,NA
"818","LRP2",12,6,6,0,1,NA
"819","LSM1",11,1,10,0,1,NA
"820","LSM5",6,4,2,0,1,NA
"821","MACF1",4,2,2,0,1,NA
"822","MAD1L1",8,7,1,0,1,NA
"823","MAD2L1",7,2,5,0,1,NA
"824","MAFK",2,1,1,0,1,NA
"825","MAGEA11",9,6,3,0,1,NA
"826","MAGEA4",2,1,1,0,1,NA
"827","MAP1B",8,2,6,0,1,NA
"828","MAP1LC3B",14,13,1,0,1,NA
"829","MAP2K1",20,7,13,0,1,NA
"830","MAP2K7",6,4,2,0,1,NA
"831","MAP3K14",11,6,5,0,1,NA
"832","MAPK14",19,13,6,0,1,NA
"833","MAPK3",45,34,11,0,1,NA
"834","MAPK6",58,33,25,0,1,NA
"835","MAPK8IP2",8,3,5,0,1,NA
"836","MARK3",10,6,4,0,1,NA
"837","MBIP",12,7,5,0,1,NA
"838","MBP",10,3,7,0,1,NA
"839","MCM10",15,7,8,0,1,NA
"840","MDFI",26,21,5,0,1,NA
"841","MDM2",13,6,7,0,1,NA
"842","MECP2",7,3,4,0,1,NA
"843","MED17",4,2,2,0,1,NA
"844","MED19",3,1,2,0,1,NA
"845","MED22",3,1,2,0,1,NA
"846","MED25",7,3,4,0,1,NA
"847","MED8",19,11,8,0,1,NA
"848","MED9",8,4,4,0,1,NA
"849","MEOX1",3,2,1,0,1,NA
"850","MET",14,4,10,0,1,NA
"851","MINK1",4,1,3,0,1,NA
"852","MLLT3",3,1,2,0,1,NA
"853","MLNR",2,1,1,0,1,NA
"854","MMP3",4,3,1,0,1,NA
"855","MPDZ",5,1,4,0,1,NA
"856","MPHOSPH6",5,3,2,0,1,NA
"857","MSX1",8,3,5,0,1,NA
"858","MYC",18,6,12,0,1,NA
"859","MYD88",13,4,9,0,1,NA
"860","NANOS1",3,2,1,0,1,NA
"861","NAPA",6,2,4,0,1,NA
"862","NCAN",4,3,1,0,1,NA
"863","NCK1",24,2,22,0,1,NA
"864","NCL",9,6,3,0,1,NA
"865","NCOA1",31,17,14,0,1,NA
"866","NCOA6",13,6,7,0,1,NA
"867","NCOR1",23,11,12,0,1,NA
"868","NDC80",12,5,7,0,1,NA
"869","NEDD8",4,2,2,0,1,NA
"870","NEK2",7,2,5,0,1,NA
"871","NFIC",3,2,1,0,1,NA
"872","NFKB1",27,14,13,0,1,NA
"873","NFYA",6,3,3,0,1,NA
"874","NGFR",17,5,12,0,1,NA
"875","NIF3L1",22,16,6,0,1,NA
"876","NME1",7,2,5,0,1,NA
"877","NOTCH1",17,10,7,0,1,NA
"878","NOV",5,3,2,0,1,NA
"879","NR3C1",21,3,18,0,1,NA
"880","NR4A1",8,1,7,0,1,NA
"881","NR5A1",7,2,5,0,1,NA
"882","NTF3",2,1,1,0,1,NA
"883","NUDT21",13,6,7,0,1,NA
"884","NUMA1",6,5,1,0,1,NA
"885","OPRD1",8,2,6,0,1,NA
"886","P4HB",5,3,2,0,1,NA
"887","PAFAH1B1",7,2,5,0,1,NA
"888","PAK1",27,18,9,0,1,NA
"889","PCNA",27,23,4,0,1,NA
"890","PDE6D",10,1,9,0,1,NA
"891","PDGFRB",20,3,17,0,1,NA
"892","PDLIM7",7,3,4,0,1,NA
"893","PDPK1",25,16,9,0,1,NA
"894","PFDN1",14,8,6,0,1,NA
"895","PFN1",13,5,8,0,1,NA
"896","PFN2",7,1,6,0,1,NA
"897","PIK3R2",21,17,4,0,1,NA
"898","PIK3R3",13,8,5,0,1,NA
"899","PIN1",23,13,10,0,1,NA
"900","PIP4K2A",2,1,1,0,1,NA
"901","PIP4K2C",4,1,3,0,1,NA
"902","PKD1",10,7,3,0,1,NA
"903","PLCD1",5,2,3,0,1,NA
"904","PLCG1",46,18,28,0,1,NA
"905","PLEKHF2",11,9,2,0,1,NA
"906","PLG",8,5,3,0,1,NA
"907","PLK1",27,12,15,0,1,NA
"908","PLSCR1",25,9,16,0,1,NA
"909","PNN",6,2,4,0,1,NA
"910","POLA2",12,4,8,0,1,NA
"911","POLR2A",33,23,10,0,1,NA
"912","POLR3F",5,2,3,0,1,NA
"913","PPBP",4,1,3,0,1,NA
"914","PPFIBP2",4,2,2,0,1,NA
"915","PQBP1",4,3,1,0,1,NA
"916","PRKACA",26,6,20,0,1,NA
"917","PRKAR2A",4,3,1,0,1,NA
"918","PRKCG",17,5,12,0,1,NA
"919","PRKCQ",8,2,6,0,1,NA
"920","PRKD2",12,10,2,0,1,NA
"921","PRMT1",16,8,8,0,1,NA
"922","PROX1",4,2,2,0,1,NA
"923","PRTN3",4,3,1,0,1,NA
"924","PSEN1",17,9,8,0,1,NA
"925","PSMD4",2,1,1,0,1,NA
"926","PTGES3",7,6,1,0,1,NA
"927","PTGS2",2,1,1,0,1,NA
"928","PTK2",27,14,13,0,1,NA
"929","PTPN6",32,4,28,0,1,NA
"930","PTPRC",25,14,11,0,1,NA
"931","RAB1A",9,7,2,0,1,NA
"932","RAB27A",8,5,3,0,1,NA
"933","RAB8A",4,2,2,0,1,NA
"934","RAC1",17,4,13,0,1,NA
"935","RAF1",28,16,12,0,1,NA
"936","RAMP3",3,1,2,0,1,NA
"937","RAP1A",12,5,7,0,1,NA
"938","RAP2A",9,4,5,0,1,NA
"939","RASA1",35,16,19,0,1,NA
"940","RB1",100,80,20,0,1,NA
"941","RBL2",18,13,5,0,1,NA
"942","RBM8A",3,1,2,0,1,NA
"943","RBPMS",14,12,2,0,1,NA
"944","RBX1",8,6,2,0,1,NA
"945","RCVRN",2,1,1,0,1,NA
"946","RDX",7,3,4,0,1,NA
"947","RELA",38,8,30,0,1,NA
"948","RGS19",12,6,6,0,1,NA
"949","RGS2",21,2,19,0,1,NA
"950","RING1",6,5,1,0,1,NA
"951","RLN3",2,1,1,0,1,NA
"952","RNF11",24,12,12,0,1,NA
"953","RNF7",4,1,3,0,1,NA
"954","RNPS1",5,4,1,0,1,NA
"955","ROCK1",8,4,4,0,1,NA
"956","RPGR",3,1,2,0,1,NA
"957","RPS6KA3",13,6,7,0,1,NA
"958","RUNX1",6,4,2,0,1,NA
"959","RXRA",36,12,24,0,1,NA
"960","RXRB",11,7,4,0,1,NA
"961","RYR1",7,6,1,0,1,NA
"962","S100A4",3,2,1,0,1,NA
"963","S1PR1",4,1,3,0,1,NA
"964","SAFB",14,9,5,0,1,NA
"965","SDC1",4,1,3,0,1,NA
"966","SH3GL2",6,4,2,0,1,NA
"967","SHANK1",10,2,8,0,1,NA
"968","SHBG",6,2,4,0,1,NA
"969","SIAH1",12,10,2,0,1,NA
"970","SIRPA",3,2,1,0,1,NA
"971","SIX3",2,1,1,0,1,NA
"972","SKP1",8,5,3,0,1,NA
"973","SLC9A3R1",13,6,7,0,1,NA
"974","SMAD3",31,11,20,0,1,NA
"975","SMAD5",13,4,9,0,1,NA
"976","SMAD7",7,2,5,0,1,NA
"977","SMG1",4,2,2,0,1,NA
"978","SNAP25",2,1,1,0,1,NA
"979","SNCA",13,3,10,0,1,NA
"980","SNRNP70",9,4,5,0,1,NA
"981","SNRPB",12,10,2,0,1,NA
"982","SNRPD2",6,2,4,0,1,NA
"983","SNX1",6,4,2,0,1,NA
"984","SNX2",10,4,6,0,1,NA
"985","SNX4",7,4,3,0,1,NA
"986","SOS1",26,11,15,0,1,NA
"987","SOX8",10,5,5,0,1,NA
"988","SPTBN4",7,3,4,0,1,NA
"989","SRC",55,24,31,0,1,NA
"990","SRF",20,11,9,0,1,NA
"991","SRGN",7,4,3,0,1,NA
"992","SST",4,2,2,0,1,NA
"993","SSTR5",3,1,2,0,1,NA
"994","STRN4",10,4,6,0,1,NA
"995","STX11",5,3,2,0,1,NA
"996","STX3",3,1,2,0,1,NA
"997","STX8",5,3,2,0,1,NA
"998","STXBP1",5,4,1,0,1,NA
"999","SUMO1",25,20,5,0,1,NA
"1000","SYNCRIP",5,4,1,0,1,NA
"1001","SYT4",3,1,2,0,1,NA
"1002","TARBP2",3,1,2,0,1,NA
"1003","TGFBR1",29,12,17,0,1,NA
"1004","TGM2",11,3,8,0,1,NA
"1005","TK1",44,32,12,0,1,NA
"1006","TLE1",27,23,4,0,1,NA
"1007","TLN1",10,5,5,0,1,NA
"1008","TNFRSF1A",25,9,16,0,1,NA
"1009","TNFRSF4",6,1,5,0,1,NA
"1010","TNNT1",15,8,7,0,1,NA
"1011","TOPBP1",6,3,3,0,1,NA
"1012","TP53",44,9,35,0,1,NA
"1013","TRAF1",16,7,9,0,1,NA
"1014","TRAF4",13,8,5,0,1,NA
"1015","TRAF6",22,6,16,0,1,NA
"1016","TRIM27",7,5,2,0,1,NA
"1017","TRIM37",17,8,9,0,1,NA
"1018","TRIM5",3,2,1,0,1,NA
"1019","TRIP6",12,8,4,0,1,NA
"1020","TRPC3",4,2,2,0,1,NA
"1021","TSG101",6,2,4,0,1,NA
"1022","TTR",11,5,6,0,1,NA
"1023","TUBB",17,5,12,0,1,NA
"1024","U2AF2",7,3,4,0,1,NA
"1025","UBE2D3",8,6,2,0,1,NA
"1026","UBE2L6",5,2,3,0,1,NA
"1027","UBE3A",21,18,3,0,1,NA
"1028","UBQLN1",8,5,3,0,1,NA
"1029","UBQLN4",29,15,14,0,1,NA
"1030","UNC119",33,14,19,0,1,NA
"1031","UTP14A",19,7,12,0,1,NA
"1032","VCAN",10,4,6,0,1,NA
"1033","VDAC1",4,1,3,0,1,NA
"1034","VHL",5,2,3,0,1,NA
"1035","WBP11",5,4,1,0,1,NA
"1036","WDYHV1",10,4,6,0,1,NA
"1037","WWP1",7,4,3,0,1,NA
"1038","WWP2",6,1,5,0,1,NA
"1039","XRCC4",4,2,2,0,1,NA
"1040","XRCC6",25,9,16,0,1,NA
"1041","XRN2",9,4,5,0,1,NA
"1042","YES1",10,7,3,0,1,NA
"1043","YWHAE",16,6,10,0,1,NA
"1044","YWHAG",93,67,26,0,1,NA
"1045","YWHAH",21,16,5,0,1,NA
"1046","YWHAQ",33,19,14,0,1,NA
"1047","ZBTB17",11,6,5,0,1,NA
"1048","ZMYND19",4,1,3,0,1,NA
"1049","ZNF446",3,1,2,0,1,NA
"1050","ZNF512B",12,2,10,0,1,NA
"1051","A1CF",1,0,1,1,0,NA
"1052","AAMP",1,0,1,1,0,NA
"1053","ABCB1",1,0,1,1,0,NA
"1054","ABCC9",1,0,1,1,0,NA
"1055","ACIN1",1,0,1,2,0,NA
"1056","ACP1",4,0,4,2,0,NA
"1057","ACTR2",3,0,3,2,0,NA
"1058","ACVR2B",4,0,4,2,0,NA
"1059","ADAMTS10",2,0,2,2,0,NA
"1060","ADCY6",1,0,1,1,0,NA
"1061","ADCYAP1R1",2,0,2,2,0,NA
"1062","ADIPOR1",1,0,1,2,0,NA
"1063","ADORA1",2,0,2,1,0,NA
"1064","ADORA2B",2,0,2,2,0,NA
"1065","ADRA1B",2,0,2,2,0,NA
"1066","ADRA2B",1,0,1,1,0,NA
"1067","AGER",1,0,1,1,0,NA
"1068","AKIRIN2",1,0,1,1,0,NA
"1069","ALK",1,0,1,1,0,NA
"1070","AMHR2",2,0,2,2,0,NA
"1071","ANK1",3,0,3,2,0,NA
"1072","ANKRD11",1,0,1,1,0,NA
"1073","AP1G1",2,0,2,2,0,NA
"1074","AP4M1",2,0,2,2,0,NA
"1075","APCS",2,0,2,1,0,NA
"1076","APEX2",2,0,2,1,0,NA
"1077","APOA1BP",1,0,1,1,0,NA
"1078","APOA2",1,0,1,2,0,NA
"1079","APOB",2,0,2,2,0,NA
"1080","APOBEC1",1,0,1,1,0,NA
"1081","ARHGAP1",7,0,7,2,0,NA
"1082","ARL6IP1",1,0,1,1,0,NA
"1083","ARR3",2,0,2,2,0,NA
"1084","ASGR2",2,0,2,2,0,NA
"1085","ASH2L",1,0,1,1,0,NA
"1086","ATF5",1,0,1,1,0,NA
"1087","ATG9A",1,0,1,2,0,NA
"1088","ATP6V0C",1,0,1,1,0,NA
"1089","ATP6V1A",2,0,2,1,0,NA
"1090","ATP6V1E1",3,0,3,2,0,NA
"1091","AVPR1A",1,0,1,1,0,NA
"1092","AVPR2",2,0,2,2,0,NA
"1093","BAI1",1,0,1,1,0,NA
"1094","BAI2",2,0,2,2,0,NA
"1095","BCL2L11",2,0,2,1,0,NA
"1096","BDKRB2",2,0,2,2,0,NA
"1097","BEND7",2,0,2,2,0,NA
"1098","BIRC6",1,0,1,2,0,NA
"1099","BRAP",1,0,1,1,0,NA
"1100","C10orf88",1,0,1,1,0,NA
"1101","C19orf57",1,0,1,2,0,NA
"1102","C1D",1,0,1,1,0,NA
"1103","C1orf94",1,0,1,1,0,NA
"1104","C5AR1",3,0,3,2,0,NA
"1105","C9orf114",1,0,1,1,0,NA
"1106","CABLES2",1,0,1,1,0,NA
"1107","CACNA1D",1,0,1,1,0,NA
"1108","CADM1",1,0,1,1,0,NA
"1109","CAPZA1",2,0,2,2,0,NA
"1110","CASP2",5,0,5,1,0,NA
"1111","CASR",2,0,2,2,0,NA
"1112","CAV2",6,0,6,2,0,NA
"1113","CCL16",1,0,1,1,0,NA
"1114","CCL17",1,0,1,2,0,NA
"1115","CCL19",1,0,1,1,0,NA
"1116","CCL25",1,0,1,2,0,NA
"1117","CCL7",2,0,2,2,0,NA
"1118","CCNB1",9,0,9,2,0,NA
"1119","CCNB2",3,0,3,1,0,NA
"1120","CCNC",2,0,2,1,0,NA
"1121","CCNK",7,0,7,2,0,NA
"1122","CCNL2",1,0,1,1,0,NA
"1123","CCR4",1,0,1,1,0,NA
"1124","CCRL1",4,0,4,2,0,NA
"1125","CD14",1,0,1,1,0,NA
"1126","CD151",1,0,1,2,0,NA
"1127","CD19",11,0,11,2,0,NA
"1128","CD1D",2,0,2,2,0,NA
"1129","CD226",2,0,2,1,0,NA
"1130","CD36",8,0,8,2,0,NA
"1131","CD3G",1,0,1,1,0,NA
"1132","CD6",1,0,1,1,0,NA
"1133","CD80",1,0,1,1,0,NA
"1134","CD8A",1,0,1,1,0,NA
"1135","CD93",9,0,9,2,0,NA
"1136","CDC5L",1,0,1,2,0,NA
"1137","CDCA3",1,0,1,1,0,NA
"1138","CDH24",1,0,1,1,0,NA
"1139","CDK5R2",1,0,1,1,0,NA
"1140","CDK5RAP1",1,0,1,1,0,NA
"1141","CDKN2C",1,0,1,1,0,NA
"1142","CDKN3",1,0,1,1,0,NA
"1143","CENPE",1,0,1,1,0,NA
"1144","CETP",1,0,1,1,0,NA
"1145","CFTR",3,0,3,2,0,NA
"1146","CHAF1B",1,0,1,2,0,NA
"1147","CHCHD3",1,0,1,1,0,NA
"1148","CHMP4C",1,0,1,1,0,NA
"1149","CHRM1",1,0,1,1,0,NA
"1150","CHRM4",3,0,3,2,0,NA
"1151","CHRND",1,0,1,1,0,NA
"1152","CKB",1,0,1,1,0,NA
"1153","CKM",1,0,1,1,0,NA
"1154","CLIC1",2,0,2,2,0,NA
"1155","CLK1",1,0,1,1,0,NA
"1156","CLUAP1",1,0,1,1,0,NA
"1157","CMTM3",3,0,3,1,0,NA
"1158","CNNM3",1,0,1,1,0,NA
"1159","CNOT4",1,0,1,1,0,NA
"1160","CNOT7",1,0,1,2,0,NA
"1161","CNPY4",1,0,1,1,0,NA
"1162","CNTFR",3,0,3,2,0,NA
"1163","COG5",1,0,1,2,0,NA
"1164","COL4A3",1,0,1,2,0,NA
"1165","COL4A4",1,0,1,1,0,NA
"1166","COL4A6",2,0,2,1,0,NA
"1167","COL8A1",2,0,2,1,0,NA
"1168","COMT",2,0,2,2,0,NA
"1169","COPG2",1,0,1,1,0,NA
"1170","CPSF1",5,0,5,1,0,NA
"1171","CREB3L3",1,0,1,2,0,NA
"1172","CREG1",1,0,1,1,0,NA
"1173","CRHR2",1,0,1,2,0,NA
"1174","CRX",1,0,1,2,0,NA
"1175","CRY2",1,0,1,1,0,NA
"1176","CRYM",1,0,1,1,0,NA
"1177","CSF1R",9,0,9,2,0,NA
"1178","CSF2RA",2,0,2,1,0,NA
"1179","CSNK1G2",1,0,1,2,0,NA
"1180","CSTA",1,0,1,1,0,NA
"1181","CTSS",2,0,2,2,0,NA
"1182","CXCL10",2,0,2,2,0,NA
"1183","CXCR3",1,0,1,2,0,NA
"1184","CXCR5",1,0,1,1,0,NA
"1185","DAPK1",2,0,2,1,0,NA
"1186","DBF4",3,0,3,2,0,NA
"1187","DBP",1,0,1,2,0,NA
"1188","DCK",1,0,1,2,0,NA
"1189","DCTPP1",1,0,1,1,0,NA
"1190","DDB1",1,0,1,2,0,NA
"1191","DEAF1",1,0,1,1,0,NA
"1192","DEK",1,0,1,1,0,NA
"1193","DFFA",1,0,1,1,0,NA
"1194","DGCR2",1,0,1,1,0,NA
"1195","DIAPH2",1,0,1,1,0,NA
"1196","DIS3L2",1,0,1,1,0,NA
"1197","DKC1",1,0,1,1,0,NA
"1198","DLGAP4",3,0,3,2,0,NA
"1199","DMAP1",2,0,2,1,0,NA
"1200","DNM3",1,0,1,1,0,NA
"1201","DNMT1",8,0,8,2,0,NA
"1202","DOM3Z",3,0,3,1,0,NA
"1203","DPYSL4",1,0,1,2,0,NA
"1204","DRD3",3,0,3,1,0,NA
"1205","DRD5",2,0,2,1,0,NA
"1206","DTX1",1,0,1,1,0,NA
"1207","DTX2",2,0,2,1,0,NA
"1208","DTX3L",1,0,1,1,0,NA
"1209","DUSP16",1,0,1,1,0,NA
"1210","DUSP9",1,0,1,1,0,NA
"1211","DYNC1I2",1,0,1,1,0,NA
"1212","DYNLT3",1,0,1,2,0,NA
"1213","DYRK1B",1,0,1,1,0,NA
"1214","ECH1",2,0,2,1,0,NA
"1215","ECT2",2,0,2,1,0,NA
"1216","EDA2R",3,0,3,1,0,NA
"1217","EDAR",1,0,1,1,0,NA
"1218","EDN3",1,0,1,2,0,NA
"1219","EEF1B2",2,0,2,2,0,NA
"1220","EIF5",1,0,1,1,0,NA
"1221","ELAC2",1,0,1,1,0,NA
"1222","EMCN",1,0,1,1,0,NA
"1223","EML4",1,0,1,1,0,NA
"1224","ENAH",3,0,3,2,0,NA
"1225","EPB49",3,0,3,2,0,NA
"1226","EPHA4",3,0,3,2,0,NA
"1227","EPHA8",2,0,2,1,0,NA
"1228","EPHB1",1,0,1,2,0,NA
"1229","EPOR",6,0,6,2,0,NA
"1230","ERP27",1,0,1,1,0,NA
"1231","ESR2",6,0,6,2,0,NA
"1232","EXOC5",2,0,2,1,0,NA
"1233","EXOSC10",6,0,6,2,0,NA
"1234","F12",1,0,1,2,0,NA
"1235","FAM124B",2,0,2,1,0,NA
"1236","FATE1",1,0,1,1,0,NA
"1237","FBL",2,0,2,1,0,NA
"1238","FBXW5",1,0,1,1,0,NA
"1239","FBXW7",4,0,4,2,0,NA
"1240","FCGR3A",4,0,4,2,0,NA
"1241","FEZ2",1,0,1,1,0,NA
"1242","FFAR1",1,0,1,1,0,NA
"1243","FFAR2",1,0,1,2,0,NA
"1244","FGFBP1",1,0,1,2,0,NA
"1245","FGFR2",2,0,2,1,0,NA
"1246","FHIT",1,0,1,1,0,NA
"1247","FIZ1",1,0,1,2,0,NA
"1248","FLNC",2,0,2,2,0,NA
"1249","FNTA",2,0,2,1,0,NA
"1250","FOXP1",2,0,2,2,0,NA
"1251","FSHR",3,0,3,2,0,NA
"1252","FUBP1",2,0,2,1,0,NA
"1253","FXYD1",2,0,2,2,0,NA
"1254","FXYD6",1,0,1,1,0,NA
"1255","FZD1",2,0,2,2,0,NA
"1256","FZD5",1,0,1,2,0,NA
"1257","FZD6",1,0,1,2,0,NA
"1258","G3BP1",1,0,1,1,0,NA
"1259","GAB3",3,0,3,1,0,NA
"1260","GABBR1",2,0,2,2,0,NA
"1261","GABRG2",2,0,2,2,0,NA
"1262","GAD2",2,0,2,2,0,NA
"1263","GALR1",1,0,1,2,0,NA
"1264","GANAB",1,0,1,2,0,NA
"1265","GARS",2,0,2,2,0,NA
"1266","GATAD2A",2,0,2,2,0,NA
"1267","GBF1",1,0,1,1,0,NA
"1268","GBP2",2,0,2,2,0,NA
"1269","GCC1",1,0,1,1,0,NA
"1270","GCSH",1,0,1,1,0,NA
"1271","GEMIN6",1,0,1,1,0,NA
"1272","GFRA1",1,0,1,2,0,NA
"1273","GFRA2",1,0,1,2,0,NA
"1274","GHRHR",1,0,1,2,0,NA
"1275","GKAP1",1,0,1,1,0,NA
"1276","GLB1",3,0,3,1,0,NA
"1277","GLI1",1,0,1,1,0,NA
"1278","GLRA2",1,0,1,2,0,NA
"1279","GMEB1",3,0,3,1,0,NA
"1280","GNL3",1,0,1,1,0,NA
"1281","GOLGA3",4,0,4,1,0,NA
"1282","GOLGA4",1,0,1,2,0,NA
"1283","GOSR2",1,0,1,1,0,NA
"1284","GP1BA",1,0,1,1,0,NA
"1285","GPC1",3,0,3,2,0,NA
"1286","GPD1",1,0,1,2,0,NA
"1287","GPNMB",1,0,1,1,0,NA
"1288","GPR37",2,0,2,2,0,NA
"1289","GRIK1",1,0,1,1,0,NA
"1290","GRIK3",1,0,1,1,0,NA
"1291","GRK1",2,0,2,1,0,NA
"1292","GRM3",1,0,1,1,0,NA
"1293","GRM4",2,0,2,1,0,NA
"1294","GRM7",2,0,2,1,0,NA
"1295","GRM8",1,0,1,1,0,NA
"1296","GRP",1,0,1,1,0,NA
"1297","GSTM4",1,0,1,1,0,NA
"1298","GZMA",1,0,1,1,0,NA
"1299","H3F3B",1,0,1,1,0,NA
"1300","HBP1",3,0,3,1,0,NA
"1301","HCRTR2",1,0,1,2,0,NA
"1302","HES1",8,0,8,2,0,NA
"1303","HHIP",1,0,1,1,0,NA
"1304","HIPK1",1,0,1,1,0,NA
"1305","HIST1H1B",1,0,1,1,0,NA
"1306","HIST1H2AB",1,0,1,2,0,NA
"1307","HNRNPA1",4,0,4,2,0,NA
"1308","HNRNPH3",1,0,1,1,0,NA
"1309","HNRNPR",1,0,1,1,0,NA
"1310","HOXB2",1,0,1,2,0,NA
"1311","HOXB6",2,0,2,2,0,NA
"1312","HPCAL4",1,0,1,1,0,NA
"1313","HSBP1",1,0,1,2,0,NA
"1314","HSD17B10",1,0,1,1,0,NA
"1315","HSPB2",1,0,1,1,0,NA
"1316","HSPB8",1,0,1,1,0,NA
"1317","HTR1A",1,0,1,1,0,NA
"1318","HTR1B",1,0,1,2,0,NA
"1319","HTR2C",3,0,3,2,0,NA
"1320","HTR3A",1,0,1,2,0,NA
"1321","IFNAR2",5,0,5,2,0,NA
"1322","IFNG",2,0,2,1,0,NA
"1323","IGF2R",4,0,4,2,0,NA
"1324","IGFBP1",1,0,1,1,0,NA
"1325","IGFBP2",1,0,1,1,0,NA
"1326","IKZF3",1,0,1,2,0,NA
"1327","IL10RA",2,0,2,2,0,NA
"1328","IL12RB1",1,0,1,2,0,NA
"1329","IL13",1,0,1,1,0,NA
"1330","IL13RA1",1,0,1,2,0,NA
"1331","IL15RA",3,0,3,2,0,NA
"1332","IL17RB",1,0,1,2,0,NA
"1333","IL18R1",2,0,2,2,0,NA
"1334","IL18RAP",2,0,2,2,0,NA
"1335","IL1R1",4,0,4,2,0,NA
"1336","IL1RL1",1,0,1,2,0,NA
"1337","IL21R",1,0,1,1,0,NA
"1338","IL3",2,0,2,2,0,NA
"1339","IL31RA",2,0,2,2,0,NA
"1340","IL7R",5,0,5,2,0,NA
"1341","IL9R",1,0,1,2,0,NA
"1342","INA",1,0,1,1,0,NA
"1343","INHBC",1,0,1,2,0,NA
"1344","INPP5K",1,0,1,1,0,NA
"1345","IPO5",2,0,2,2,0,NA
"1346","ITGAL",4,0,4,2,0,NA
"1347","ITGAX",3,0,3,2,0,NA
"1348","ITGB1BP1",3,0,3,1,0,NA
"1349","ITGB4",5,0,5,2,0,NA
"1350","ITGB7",5,0,5,2,0,NA
"1351","ITM2B",1,0,1,1,0,NA
"1352","ITM2C",1,0,1,2,0,NA
"1353","ITPR2",1,0,1,2,0,NA
"1354","ITSN2",3,0,3,1,0,NA
"1355","JAM2",1,0,1,1,0,NA
"1356","JAM3",1,0,1,1,0,NA
"1357","KCMF1",1,0,1,1,0,NA
"1358","KCNA2",1,0,1,2,0,NA
"1359","KCNJ15",1,0,1,1,0,NA
"1360","KCNMB1",1,0,1,1,0,NA
"1361","KCNQ5",1,0,1,1,0,NA
"1362","KCTD15",1,0,1,2,0,NA
"1363","KHDRBS2",2,0,2,2,0,NA
"1364","KHSRP",3,0,3,2,0,NA
"1365","KIF11",1,0,1,1,0,NA
"1366","KIF1C",1,0,1,1,0,NA
"1367","KIF20B",1,0,1,1,0,NA
"1368","KIF23",2,0,2,1,0,NA
"1369","KLHL20",2,0,2,1,0,NA
"1370","KLK1",1,0,1,2,0,NA
"1371","KLK3",1,0,1,1,0,NA
"1372","KREMEN1",1,0,1,1,0,NA
"1373","KRIT1",1,0,1,2,0,NA
"1374","KRT20",1,0,1,1,0,NA
"1375","KRT5",2,0,2,1,0,NA
"1376","KRT8",4,0,4,1,0,NA
"1377","LAMA1",4,0,4,2,0,NA
"1378","LAMA3",1,0,1,1,0,NA
"1379","LAT",1,0,1,2,0,NA
"1380","LBP",1,0,1,1,0,NA
"1381","LEPR",6,0,6,2,0,NA
"1382","LHCGR",3,0,3,2,0,NA
"1383","LHX3",2,0,2,2,0,NA
"1384","LILRB1",1,0,1,2,0,NA
"1385","LILRB2",1,0,1,2,0,NA
"1386","LIN7C",1,0,1,1,0,NA
"1387","LMNB1",5,0,5,2,0,NA
"1388","LOXL4",1,0,1,1,0,NA
"1389","LPA",1,0,1,1,0,NA
"1390","LPAR2",1,0,1,1,0,NA
"1391","LPHN1",3,0,3,2,0,NA
"1392","LRP10",1,0,1,2,0,NA
"1393","LRP12",2,0,2,1,0,NA
"1394","LRP5",1,0,1,1,0,NA
"1395","LRP8",4,0,4,2,0,NA
"1396","LRSAM1",3,0,3,2,0,NA
"1397","LSM2",2,0,2,2,0,NA
"1398","LSM4",2,0,2,2,0,NA
"1399","LTBP4",1,0,1,1,0,NA
"1400","LTBR",2,0,2,2,0,NA
"1401","LYL1",1,0,1,1,0,NA
"1402","MADD",1,0,1,1,0,NA
"1403","MAFA",2,0,2,2,0,NA
"1404","MAP1LC3A",1,0,1,1,0,NA
"1405","MAP1S",1,0,1,1,0,NA
"1406","MAP3K10",5,0,5,2,0,NA
"1407","MAPKBP1",1,0,1,1,0,NA
"1408","MATR3",3,0,3,2,0,NA
"1409","MC1R",1,0,1,1,0,NA
"1410","MC3R",1,0,1,1,0,NA
"1411","MC5R",1,0,1,1,0,NA
"1412","MCHR1",1,0,1,2,0,NA
"1413","MDC1",1,0,1,1,0,NA
"1414","MED28",3,0,3,1,0,NA
"1415","MEGF11",1,0,1,1,0,NA
"1416","MERTK",1,0,1,2,0,NA
"1417","MITF",2,0,2,2,0,NA
"1418","MLF1IP",6,0,6,2,0,NA
"1419","MMP13",1,0,1,1,0,NA
"1420","MMP9",10,0,10,2,0,NA
"1421","MOAP1",5,0,5,2,0,NA
"1422","MPL",1,0,1,1,0,NA
"1423","MPP2",1,0,1,1,0,NA
"1424","MRFAP1L1",1,0,1,2,0,NA
"1425","MRPL37",1,0,1,1,0,NA
"1426","MS4A1",1,0,1,1,0,NA
"1427","MSH6",1,0,1,1,0,NA
"1428","MTF2",3,0,3,1,0,NA
"1429","MTNR1A",2,0,2,1,0,NA
"1430","MUTYH",1,0,1,1,0,NA
"1431","MVP",1,0,1,2,0,NA
"1432","MYH9",3,0,3,2,0,NA
"1433","MYL2",1,0,1,2,0,NA
"1434","MYO7A",5,0,5,2,0,NA
"1435","MYOD1",7,0,7,2,0,NA
"1436","MYOZ1",2,0,2,1,0,NA
"1437","NAGPA",1,0,1,1,0,NA
"1438","NAT14",1,0,1,1,0,NA
"1439","NCBP1",4,0,4,2,0,NA
"1440","NCOA5",1,0,1,1,0,NA
"1441","NCR3",1,0,1,2,0,NA
"1442","NCSTN",1,0,1,1,0,NA
"1443","NDUFA6",1,0,1,1,0,NA
"1444","NEFM",1,0,1,1,0,NA
"1445","NEU4",1,0,1,1,0,NA
"1446","NF1",1,0,1,1,0,NA
"1447","NFKBIZ",1,0,1,2,0,NA
"1448","NGEF",4,0,4,1,0,NA
"1449","NHLH1",1,0,1,1,0,NA
"1450","NIPSNAP1",1,0,1,2,0,NA
"1451","NIT1",1,0,1,1,0,NA
"1452","NLGN2",2,0,2,1,0,NA
"1453","NOC4L",2,0,2,2,0,NA
"1454","NONO",4,0,4,1,0,NA
"1455","NOS1AP",2,0,2,2,0,NA
"1456","NPR1",1,0,1,1,0,NA
"1457","NPY",1,0,1,2,0,NA
"1458","NR2E3",2,0,2,2,0,NA
"1459","NRF1",2,0,2,2,0,NA
"1460","NRXN1",2,0,2,2,0,NA
"1461","NRXN2",4,0,4,2,0,NA
"1462","NTRK3",2,0,2,2,0,NA
"1463","NUDT5",1,0,1,1,0,NA
"1464","NUP210",1,0,1,1,0,NA
"1465","NUP50",1,0,1,1,0,NA
"1466","NXF1",9,0,9,2,0,NA
"1467","OPRL1",1,0,1,2,0,NA
"1468","OPRM1",3,0,3,2,0,NA
"1469","OXTR",1,0,1,2,0,NA
"1470","PAG1",2,0,2,1,0,NA
"1471","PAN2",1,0,1,1,0,NA
"1472","PARD6G",1,0,1,1,0,NA
"1473","PARVB",1,0,1,1,0,NA
"1474","PAX2",3,0,3,1,0,NA
"1475","PCDH8",1,0,1,1,0,NA
"1476","PCSK7",1,0,1,1,0,NA
"1477","PCYT1A",1,0,1,1,0,NA
"1478","PDCD10",1,0,1,1,0,NA
"1479","PDCD2",1,0,1,1,0,NA
"1480","PDCD5",1,0,1,1,0,NA
"1481","PDE3B",1,0,1,1,0,NA
"1482","PDHX",1,0,1,1,0,NA
"1483","PDIA6",1,0,1,1,0,NA
"1484","PEX10",1,0,1,1,0,NA
"1485","PEX14",1,0,1,1,0,NA
"1486","PEX7",1,0,1,2,0,NA
"1487","PHACTR1",1,0,1,1,0,NA
"1488","PHLDA1",1,0,1,2,0,NA
"1489","PIK3C2B",1,0,1,1,0,NA
"1490","PIK3C3",1,0,1,1,0,NA
"1491","PLA2R1",1,0,1,2,0,NA
"1492","PLAA",1,0,1,1,0,NA
"1493","PLAU",1,0,1,1,0,NA
"1494","PLEKHJ1",1,0,1,1,0,NA
"1495","PLXNA2",1,0,1,2,0,NA
"1496","POGZ",1,0,1,1,0,NA
"1497","POLB",1,0,1,1,0,NA
"1498","POLD1",1,0,1,1,0,NA
"1499","POLR2D",3,0,3,2,0,NA
"1500","POLR2E",4,0,4,2,0,NA
"1501","POU2F2",2,0,2,2,0,NA
"1502","PPA1",2,0,2,1,0,NA
"1503","PPP1R10",1,0,1,1,0,NA
"1504","PPP1R16A",6,0,6,2,0,NA
"1505","PPP1R2",3,0,3,1,0,NA
"1506","PPP1R7",1,0,1,1,0,NA
"1507","PPP1R9B",3,0,3,2,0,NA
"1508","PPP5C",3,0,3,2,0,NA
"1509","PRDM1",1,0,1,1,0,NA
"1510","PRDX1",1,0,1,2,0,NA
"1511","PRIM1",1,0,1,1,0,NA
"1512","PRMT5",7,0,7,2,0,NA
"1513","PRPF4B",2,0,2,2,0,NA
"1514","PSG3",1,0,1,1,0,NA
"1515","PSG9",1,0,1,1,0,NA
"1516","PSMA5",1,0,1,2,0,NA
"1517","PSMB1",3,0,3,1,0,NA
"1518","PTAFR",2,0,2,2,0,NA
"1519","PTCH1",1,0,1,2,0,NA
"1520","PTCH2",1,0,1,1,0,NA
"1521","PTGIR",2,0,2,2,0,NA
"1522","PTH1R",2,0,2,1,0,NA
"1523","PTPN7",1,0,1,1,0,NA
"1524","PTPRA",1,0,1,1,0,NA
"1525","PTPRH",5,0,5,2,0,NA
"1526","PTPRJ",2,0,2,2,0,NA
"1527","PTPRM",7,0,7,2,0,NA
"1528","PTPRN",2,0,2,2,0,NA
"1529","PTPRN2",1,0,1,2,0,NA
"1530","PTX3",1,0,1,2,0,NA
"1531","PVR",2,0,2,2,0,NA
"1532","QRSL1",1,0,1,1,0,NA
"1533","RAB11FIP2",5,0,5,2,0,NA
"1534","RAB22A",1,0,1,2,0,NA
"1535","RAB9A",2,0,2,2,0,NA
"1536","RAD18",1,0,1,1,0,NA
"1537","RAI1",1,0,1,2,0,NA
"1538","RAMP1",3,0,3,2,0,NA
"1539","RAMP2",1,0,1,1,0,NA
"1540","RAPGEF4",1,0,1,1,0,NA
"1541","RASA3",1,0,1,1,0,NA
"1542","RASIP1",2,0,2,1,0,NA
"1543","REN",3,0,3,2,0,NA
"1544","RER1",1,0,1,1,0,NA
"1545","RERE",2,0,2,1,0,NA
"1546","REXO1",1,0,1,1,0,NA
"1547","RFC3",1,0,1,1,0,NA
"1548","RGR",1,0,1,2,0,NA
"1549","RGS16",4,0,4,2,0,NA
"1550","RHO",1,0,1,1,0,NA
"1551","RHOQ",3,0,3,2,0,NA
"1552","RIMS2",1,0,1,2,0,NA
"1553","RMI1",1,0,1,1,0,NA
"1554","RND1",1,0,1,2,0,NA
"1555","RND2",1,0,1,2,0,NA
"1556","RNF139",1,0,1,1,0,NA
"1557","RNF183",1,0,1,2,0,NA
"1558","RNF40",2,0,2,1,0,NA
"1559","ROM1",1,0,1,2,0,NA
"1560","ROR2",2,0,2,2,0,NA
"1561","RPL13",2,0,2,1,0,NA
"1562","RPL6",1,0,1,2,0,NA
"1563","RPS25",1,0,1,1,0,NA
"1564","RRBP1",1,0,1,1,0,NA
"1565","RSRC1",1,0,1,1,0,NA
"1566","RTN4",6,0,6,2,0,NA
"1567","RUFY2",1,0,1,2,0,NA
"1568","RXFP1",1,0,1,2,0,NA
"1569","S100A1",2,0,2,1,0,NA
"1570","S100A11",1,0,1,1,0,NA
"1571","S100P",1,0,1,2,0,NA
"1572","S1PR2",1,0,1,1,0,NA
"1573","S1PR5",2,0,2,2,0,NA
"1574","SALL1",1,0,1,1,0,NA
"1575","SARS2",1,0,1,1,0,NA
"1576","SCAF1",1,0,1,1,0,NA
"1577","SCFD1",3,0,3,2,0,NA
"1578","SCIN",1,0,1,2,0,NA
"1579","SCNN1G",1,0,1,1,0,NA
"1580","SCTR",1,0,1,2,0,NA
"1581","SEC31A",1,0,1,1,0,NA
"1582","SELL",7,0,7,2,0,NA
"1583","SEMA3F",2,0,2,1,0,NA
"1584","SEMA4D",1,0,1,2,0,NA
"1585","SEMA5B",2,0,2,1,0,NA
"1586","SENP2",3,0,3,2,0,NA
"1587","SEPT2",3,0,3,2,0,NA
"1588","SEPT5",2,0,2,1,0,NA
"1589","SF3A2",2,0,2,2,0,NA
"1590","SF3B1",5,0,5,1,0,NA
"1591","SF3B4",1,0,1,2,0,NA
"1592","SFI1",1,0,1,1,0,NA
"1593","SHMT1",1,0,1,1,0,NA
"1594","SIGLEC7",1,0,1,1,0,NA
"1595","SIGMAR1",1,0,1,2,0,NA
"1596","SIX1",1,0,1,1,0,NA
"1597","SIX2",1,0,1,1,0,NA
"1598","SLC22A11",1,0,1,1,0,NA
"1599","SLC27A6",3,0,3,1,0,NA
"1600","SLC35E1",1,0,1,1,0,NA
"1601","SLC6A3",2,0,2,2,0,NA
"1602","SLC8A3",1,0,1,1,0,NA
"1603","SMARCC2",2,0,2,1,0,NA
"1604","SMC5",1,0,1,1,0,NA
"1605","SMPD1",1,0,1,2,0,NA
"1606","SMPD3",1,0,1,1,0,NA
"1607","SNAP29",1,0,1,2,0,NA
"1608","SNCG",3,0,3,2,0,NA
"1609","SNX5",3,0,3,1,0,NA
"1610","SON",2,0,2,1,0,NA
"1611","SORL1",2,0,2,2,0,NA
"1612","SORT1",2,0,2,2,0,NA
"1613","SOX9",1,0,1,1,0,NA
"1614","SP110",1,0,1,1,0,NA
"1615","SPAG8",1,0,1,1,0,NA
"1616","SPG20",1,0,1,1,0,NA
"1617","SPSB1",1,0,1,1,0,NA
"1618","SPTA1",2,0,2,1,0,NA
"1619","SPTBN2",1,0,1,2,0,NA
"1620","SREBF2",1,0,1,2,0,NA
"1621","SSTR4",1,0,1,2,0,NA
"1622","ST13",4,0,4,2,0,NA
"1623","ST14",1,0,1,2,0,NA
"1624","STAT1",13,0,13,2,0,NA
"1625","STAT5A",8,0,8,2,0,NA
"1626","STAT6",5,0,5,2,0,NA
"1627","STK3",2,0,2,2,0,NA
"1628","STK38",1,0,1,1,0,NA
"1629","STOM",1,0,1,2,0,NA
"1630","SUGT1",1,0,1,1,0,NA
"1631","SYT7",3,0,3,2,0,NA
"1632","TAC3",1,0,1,1,0,NA
"1633","TACR2",1,0,1,2,0,NA
"1634","TAP2",1,0,1,2,0,NA
"1635","TAX1BP1",4,0,4,1,0,NA
"1636","TBPL1",2,0,2,1,0,NA
"1637","TCF12",1,0,1,2,0,NA
"1638","TEAD4",1,0,1,1,0,NA
"1639","TF",3,0,3,2,0,NA
"1640","TFAM",1,0,1,2,0,NA
"1641","TFAP2B",1,0,1,2,0,NA
"1642","TFG",2,0,2,2,0,NA
"1643","THAP7",2,0,2,1,0,NA
"1644","THBD",1,0,1,2,0,NA
"1645","THEG",1,0,1,1,0,NA
"1646","THOC7",2,0,2,1,0,NA
"1647","THRB",8,0,8,2,0,NA
"1648","TIE1",1,0,1,1,0,NA
"1649","TLK1",1,0,1,1,0,NA
"1650","TLR5",1,0,1,2,0,NA
"1651","TMEM222",1,0,1,2,0,NA
"1652","TNFRSF10C",1,0,1,1,0,NA
"1653","TNFRSF17",1,0,1,1,0,NA
"1654","TNFRSF1B",4,0,4,2,0,NA
"1655","TNFRSF8",4,0,4,1,0,NA
"1656","TNFRSF9",2,0,2,2,0,NA
"1657","TOE1",2,0,2,1,0,NA
"1658","TOPORS",1,0,1,1,0,NA
"1659","TOX4",1,0,1,2,0,NA
"1660","TP53I3",1,0,1,1,0,NA
"1661","TP53RK",1,0,1,1,0,NA
"1662","TP73",1,0,1,2,0,NA
"1663","TPM3",2,0,2,1,0,NA
"1664","TPPP",1,0,1,1,0,NA
"1665","TRAF3IP1",2,0,2,1,0,NA
"1666","TRDMT1",2,0,2,1,0,NA
"1667","TREM2",1,0,1,1,0,NA
"1668","TRHR",1,0,1,2,0,NA
"1669","TRIM11",3,0,3,1,0,NA
"1670","TRIM39",1,0,1,2,0,NA
"1671","TRIM63",1,0,1,1,0,NA
"1672","TRPC4",2,0,2,2,0,NA
"1673","TRPC5",1,0,1,1,0,NA
"1674","TSPYL4",1,0,1,1,0,NA
"1675","TSSC4",1,0,1,1,0,NA
"1676","TTF2",2,0,2,2,0,NA
"1677","TUB",2,0,2,1,0,NA
"1678","TWF2",1,0,1,1,0,NA
"1679","TXNIP",1,0,1,1,0,NA
"1680","UBA2",2,0,2,1,0,NA
"1681","UBE2N",2,0,2,1,0,NA
"1682","UBE2O",1,0,1,2,0,NA
"1683","UBE2V2",1,0,1,1,0,NA
"1684","UCP2",1,0,1,1,0,NA
"1685","UCP3",1,0,1,1,0,NA
"1686","UQCRB",1,0,1,2,0,NA
"1687","UQCRQ",1,0,1,2,0,NA
"1688","UROD",1,0,1,1,0,NA
"1689","USP2",1,0,1,1,0,NA
"1690","USP33",3,0,3,2,0,NA
"1691","UTP3",1,0,1,1,0,NA
"1692","UTP6",1,0,1,1,0,NA
"1693","VANGL1",1,0,1,2,0,NA
"1694","VDAC2",1,0,1,1,0,NA
"1695","VLDLR",1,0,1,2,0,NA
"1696","VPS33B",1,0,1,1,0,NA
"1697","WASF2",6,0,6,2,0,NA
"1698","WASF3",2,0,2,1,0,NA
"1699","WBP4",1,0,1,1,0,NA
"1700","WDR18",1,0,1,1,0,NA
"1701","WDR62",1,0,1,1,0,NA
"1702","WDTC1",1,0,1,1,0,NA
"1703","WNT5B",1,0,1,2,0,NA
"1704","WNT7B",1,0,1,2,0,NA
"1705","WT1",1,0,1,1,0,NA
"1706","XAB2",4,0,4,2,0,NA
"1707","XK",1,0,1,1,0,NA
"1708","XPC",2,0,2,1,0,NA
"1709","XPO5",1,0,1,1,0,NA
"1710","ZBED1",5,0,5,2,0,NA
"1711","ZBTB16",15,0,15,2,0,NA
"1712","ZBTB25",1,0,1,1,0,NA
"1713","ZC3H7B",1,0,1,1,0,NA
"1714","ZFPM2",2,0,2,1,0,NA
"1715","ZNF165",1,0,1,1,0,NA
"1716","ZNF219",2,0,2,1,0,NA
"1717","ZNF263",1,0,1,2,0,NA
"1718","ZNF346",1,0,1,1,0,NA
"1719","ZNF408",2,0,2,1,0,NA
"1720","ZNF746",1,0,1,1,0,NA
"1721","ZNF764",1,0,1,1,0,NA
"1722","ZW10",1,0,1,2,0,NA
