"Name","K","Kin","Kout","TypeI","TypeII"
"SYNCRIP",5,4,1,0,1
"A2M",12,5,7,0,1
"HMOX2",7,3,4,0,1
"MAP1LC3B",14,13,1,0,1
"PRKACA",26,6,20,0,1
"YWHAZ",44,10,34,0,1
"MDFI",26,21,5,0,1
"RB1",100,80,20,0,1
"FADD",17,7,10,0,1
"STX1A",21,12,9,0,1
"ABCF3",4,3,1,0,1
"EPS8",10,4,6,0,1
"PAK2",8,5,3,0,1
"SOS1",26,11,15,0,1
"KRT15",15,14,1,0,1
"ABL1",28,15,13,0,1
"BCR",16,10,6,0,1
"POLR2A",33,23,10,0,1
"PRKD1",12,9,3,0,1
"SFN",19,14,5,0,1
"YWHAE",16,6,10,0,1
"CALCOCO2",12,5,7,0,1
"VIM",48,28,20,0,1
"YWHAG",93,67,26,0,1
"ATXN1",34,18,16,0,1
"CSNK2A1",49,36,13,0,1
"CSNK2A2",31,18,13,0,1
"CTNNB1",56,36,20,0,1
"LCK",40,18,22,0,1
"CFL1",10,5,5,0,1
"ACTB",59,36,23,0,1
"ANXA7",51,33,18,0,1
"BCL2L1",17,13,4,0,1
"CPNE2",4,3,1,0,1
"CSNK1A1",12,7,5,0,1
"EEF1A1",43,19,24,0,1
"H2AFX",10,5,5,0,1
"PFDN1",14,8,6,0,1
"TK1",44,32,12,0,1
"ACTN4",10,7,3,0,1
"VCL",36,18,18,0,1
"ACTG1",15,3,12,0,1
"ATF7IP",18,8,10,0,1
"VASP",14,12,2,0,1
"ARHGDIA",13,12,1,0,1
"TRRAP",7,5,2,0,1
"ACTN1",21,12,9,0,1
"CDK5",28,21,7,0,1
"COIL",20,15,5,0,1
"MAGEA11",9,6,3,0,1
"CAMK2A",12,9,3,0,1
"DCTN1",12,8,4,0,1
"NUMA1",6,5,1,0,1
"ACVR1",27,12,15,0,1
"PAK1",27,18,9,0,1
"UBE2E3",5,4,1,0,1
"SNX2",10,4,6,0,1
"ACVR2A",4,3,1,0,1
"TGFBR1",29,12,17,0,1
"TGFBR2",16,5,11,0,1
"GRB2",78,41,37,0,1
"HCK",35,25,10,0,1
"MAD2L1",7,2,5,0,1
"NOTCH1",17,10,7,0,1
"PRKCD",30,15,15,0,1
"FN1",26,15,11,0,1
"RAF1",28,16,12,0,1
"CALM1",47,24,23,0,1
"APPL1",5,1,4,0,1
"EPB41L2",6,2,4,0,1
"GNAZ",6,4,2,0,1
"EZR",25,12,13,0,1
"PRKCA",56,19,37,0,1
"ADRA2A",5,2,3,0,1
"GNAI1",17,8,9,0,1
"GNAI2",31,21,10,0,1
"EIF2B1",2,1,1,0,1
"GNAO1",5,2,3,0,1
"ARRB1",13,5,8,0,1
"SLC9A3R2",14,7,7,0,1
"GIT1",27,14,13,0,1
"HMGB1",28,23,5,0,1
"PRKCB",25,15,10,0,1
"AFF1",3,1,2,0,1
"MLLT3",3,1,2,0,1
"UBE3A",21,18,3,0,1
"EGFR",68,32,36,0,1
"JAK2",18,5,13,0,1
"PLCG1",46,18,28,0,1
"ARNT",16,8,8,0,1
"NCOA1",31,17,14,0,1
"NCOA2",12,5,7,0,1
"NCOR2",35,20,15,0,1
"AIFM1",3,2,1,0,1
"AIP",3,2,1,0,1
"AKAP10",6,3,3,0,1
"PRKAR1A",6,3,3,0,1
"PRKAR2A",4,3,1,0,1
"AKAP8",7,4,3,0,1
"AKAP9",12,9,3,0,1
"CCDC85B",63,49,14,0,1
"CASP3",55,21,34,0,1
"CHUK",32,21,11,0,1
"EIF4EBP1",11,7,4,0,1
"HTT",28,16,12,0,1
"PPP2CA",18,8,10,0,1
"HSP90AA1",28,13,15,0,1
"DYNLL1",16,11,5,0,1
"PDPK1",25,16,9,0,1
"XRN1",14,10,4,0,1
"SHC1",60,30,30,0,1
"AMPH",3,1,2,0,1
"SH3GL2",6,4,2,0,1
"CSNK2B",53,20,33,0,1
"TEK",10,2,8,0,1
"ANK2",2,1,1,0,1
"NRCAM",3,1,2,0,1
"HDAC4",15,12,3,0,1
"GAPDH",22,6,16,0,1
"PLSCR1",25,9,16,0,1
"S100A6",2,1,1,0,1
"NEDD4",14,11,3,0,1
"PCNA",27,23,4,0,1
"S100A4",3,2,1,0,1
"SRC",55,24,31,0,1
"CCDC90B",11,8,3,0,1
"COPS6",23,10,13,0,1
"SETDB1",42,31,11,0,1
"TLE1",27,23,4,0,1
"AP1M1",10,2,8,0,1
"DVL2",25,11,14,0,1
"AP2A1",12,7,5,0,1
"BIN1",10,7,3,0,1
"AP2M1",7,5,2,0,1
"AP3B1",6,2,4,0,1
"ARF1",22,6,16,0,1
"CLTC",19,10,9,0,1
"GRID2",3,1,2,0,1
"HSPA1A",15,13,2,0,1
"PSEN1",17,9,8,0,1
"STXBP1",5,4,1,0,1
"PFN1",13,5,8,0,1
"EP300",84,71,13,0,1
"HDAC1",50,41,9,0,1
"EFEMP2",11,7,4,0,1
"TRIM37",17,8,9,0,1
"APOA1",5,2,3,0,1
"TTR",11,5,6,0,1
"MAPK6",58,33,25,0,1
"KPNA2",12,10,2,0,1
"APP",33,14,19,0,1
"CAV1",49,24,25,0,1
"NID1",8,6,2,0,1
"PSEN2",10,4,6,0,1
"XRCC4",4,2,2,0,1
"TRIP6",12,8,4,0,1
"AR",26,7,19,0,1
"PIAS4",27,23,4,0,1
"RELA",38,8,30,0,1
"SUMO1",25,20,5,0,1
"XRCC6",25,9,16,0,1
"COPB1",9,4,5,0,1
"INSR",33,9,24,0,1
"WBP11",5,4,1,0,1
"RASA1",35,16,19,0,1
"RHOA",23,11,12,0,1
"RBPMS",14,12,2,0,1
"VAV1",27,18,9,0,1
"ARHGEF11",6,3,3,0,1
"GNA13",16,6,10,0,1
"GNA12",6,1,5,0,1
"ARHGEF15",2,1,1,0,1
"SMARCA4",16,8,8,0,1
"UNC119",33,14,19,0,1
"FXR2",16,9,7,0,1
"ARPC3",5,2,3,0,1
"CAPNS1",6,2,4,0,1
"BMPR2",8,3,5,0,1
"CSK",16,10,6,0,1
"FLNA",17,10,7,0,1
"ASCC2",15,10,5,0,1
"GTF3C1",9,7,2,0,1
"SNRPB",12,10,2,0,1
"JUN",46,19,27,0,1
"CEBPA",13,4,9,0,1
"CEBPG",10,6,4,0,1
"DDIT3",5,3,2,0,1
"NFKB1",27,14,13,0,1
"CEBPB",25,6,19,0,1
"NFE2L2",8,4,4,0,1
"CDC34",8,6,2,0,1
"LUC7L2",20,10,10,0,1
"GABARAPL2",7,6,1,0,1
"MDM2",13,6,7,0,1
"STK11",7,4,3,0,1
"TOPBP1",6,3,3,0,1
"XRCC5",14,8,6,0,1
"ATN1",45,19,26,0,1
"EWSR1",35,16,19,0,1
"SIAH1",12,10,2,0,1
"SUMO2",16,13,3,0,1
"MAPK3",45,34,11,0,1
"ATP1B1",5,3,2,0,1
"MBIP",12,7,5,0,1
"ATP5C1",8,6,2,0,1
"YWHAB",55,33,22,0,1
"PIN1",23,13,10,0,1
"MARK3",10,6,4,0,1
"EZH2",9,1,8,0,1
"PQBP1",4,3,1,0,1
"CDKN1A",31,22,9,0,1
"AURKA",8,3,5,0,1
"NME1",7,2,5,0,1
"GRK5",7,2,5,0,1
"AXL",12,1,11,0,1
"CBL",34,18,16,0,1
"IL2RG",8,6,2,0,1
"PIK3R2",21,17,4,0,1
"B2M",5,2,3,0,1
"PRSS23",9,3,6,0,1
"PSAP",5,4,1,0,1
"BAD",22,10,12,0,1
"MAPK8",20,17,3,0,1
"YWHAH",21,16,5,0,1
"YWHAQ",33,19,14,0,1
"BAG1",7,4,3,0,1
"DAZAP2",15,8,7,0,1
"DVL3",18,13,5,0,1
"CHD3",37,23,14,0,1
"IKBKAP",11,7,4,0,1
"BID",15,9,6,0,1
"BCAR1",25,18,7,0,1
"PKD1",10,7,3,0,1
"MAPK1",43,29,14,0,1
"RXRA",36,12,24,0,1
"NCOR1",23,11,12,0,1
"RUNX1T1",13,5,8,0,1
"ERCC3",9,6,3,0,1
"CPE",6,3,3,0,1
"RBL1",18,17,1,0,1
"TRIM27",7,5,2,0,1
"NIF3L1",22,16,6,0,1
"U2AF2",7,3,4,0,1
"BMP4",4,2,2,0,1
"BIRC2",12,3,9,0,1
"JUP",14,7,7,0,1
"TRADD",15,8,7,0,1
"UBB",21,11,10,0,1
"CASP7",13,9,4,0,1
"DIABLO",4,1,3,0,1
"BLOC1S2",3,2,1,0,1
"HSPG2",8,5,3,0,1
"MAP3K8",5,4,1,0,1
"TUBB",17,5,12,0,1
"BRCA1",48,3,45,0,1
"CREB1",15,9,6,0,1
"CREBBP",80,35,45,0,1
"LMO4",9,7,2,0,1
"SMAD3",31,11,20,0,1
"HAP1",26,21,5,0,1
"HIST3H3",18,8,10,0,1
"RBL2",18,13,5,0,1
"CDC25C",10,6,4,0,1
"PDLIM7",7,3,4,0,1
"TRIM5",3,2,1,0,1
"BTK",38,3,35,0,1
"IRAK1",25,7,18,0,1
"KIT",20,6,14,0,1
"MYD88",13,4,9,0,1
"PLCG2",25,16,9,0,1
"PRKCE",16,5,11,0,1
"PRKCQ",8,2,6,0,1
"PRKCZ",28,12,16,0,1
"TUBA1A",20,6,14,0,1
"BTRC",14,6,8,0,1
"SKP1",8,5,3,0,1
"PLK1",27,12,15,0,1
"BUB1B",3,1,2,0,1
"UBQLN4",29,15,14,0,1
"C2orf44",6,2,4,0,1
"C3",4,3,1,0,1
"C7orf25",5,3,2,0,1
"C8orf33",11,6,5,0,1
"CCNE1",9,3,6,0,1
"CACNA1A",3,2,1,0,1
"SYT1",3,1,2,0,1
"DMD",8,4,4,0,1
"CALCA",2,1,1,0,1
"NRD1",2,1,1,0,1
"CALCR",4,2,2,0,1
"RAMP3",3,1,2,0,1
"MYLK",14,11,3,0,1
"MYO5A",5,3,2,0,1
"STRN4",10,4,6,0,1
"LPL",6,3,3,0,1
"SLC2A1",4,2,2,0,1
"THBS1",21,10,11,0,1
"TRAF6",22,6,16,0,1
"KPNB1",15,8,7,0,1
"RYR1",7,6,1,0,1
"CTSG",5,3,2,0,1
"PRTN3",4,3,1,0,1
"LRP1",15,8,7,0,1
"SPTAN1",17,5,12,0,1
"CAPN2",4,1,3,0,1
"RAB1A",9,7,2,0,1
"TRAF1",16,7,9,0,1
"DLG4",22,8,14,0,1
"EPB41",12,4,8,0,1
"LIN7B",4,2,2,0,1
"PRKD2",12,10,2,0,1
"CASP8",29,8,21,0,1
"ROCK1",8,4,4,0,1
"PLA2G4A",8,4,4,0,1
"IKBKB",18,13,5,0,1
"PRKCG",17,5,12,0,1
"RAC1",17,4,13,0,1
"SLC8A1",3,1,2,0,1
"RUNX1",6,4,2,0,1
"ITCH",5,2,3,0,1
"TRIM24",12,8,4,0,1
"RING1",6,5,1,0,1
"MMP1",6,4,2,0,1
"MMP3",4,3,1,0,1
"CCR1",9,6,3,0,1
"VCAM1",3,1,2,0,1
"CCL22",3,2,1,0,1
"CCR5",8,5,3,0,1
"VCAN",10,4,6,0,1
"CCL21",5,3,2,0,1
"CTSD",9,5,4,0,1
"SRGN",7,4,3,0,1
"IL8",3,2,1,0,1
"MMP14",9,1,8,0,1
"GADD45G",17,9,8,0,1
"MED8",19,11,8,0,1
"MCM10",15,7,8,0,1
"RBX1",8,6,2,0,1
"GTF2E2",16,9,7,0,1
"CDK9",17,7,10,0,1
"CCNT2",3,2,1,0,1
"JAK1",31,12,19,0,1
"CXCL13",5,4,1,0,1
"CD4",20,9,11,0,1
"CXCR4",12,4,8,0,1
"PTK2",27,14,13,0,1
"VHL",5,2,3,0,1
"HDAC3",28,20,8,0,1
"ITGB2",23,5,18,0,1
"ITGA3",6,2,4,0,1
"PIK3R1",54,27,27,0,1
"P4HB",5,3,2,0,1
"CD2",10,8,2,0,1
"FYN",67,31,36,0,1
"CD244",2,1,1,0,1
"CD247",13,2,11,0,1
"PTPRC",25,14,11,0,1
"TRAF2",65,12,53,0,1
"PIK3CG",9,7,2,0,1
"COL1A1",20,8,12,0,1
"COL1A2",16,5,11,0,1
"LYN",37,17,20,0,1
"CD3E",8,4,4,0,1
"NCL",9,6,3,0,1
"HSPA8",31,12,19,0,1
"JAK3",8,4,4,0,1
"CD44",21,8,13,0,1
"LLGL1",2,1,1,0,1
"YES1",10,7,3,0,1
"ITGAV",8,4,4,0,1
"UBQLN1",8,5,3,0,1
"CD48",5,2,3,0,1
"CD9",7,3,4,0,1
"SDCBP",13,8,5,0,1
"CD81",8,3,5,0,1
"HBEGF",6,2,4,0,1
"SAFB",14,9,5,0,1
"CDH1",9,4,5,0,1
"CDH5",8,4,4,0,1
"CDK5RAP2",9,6,3,0,1
"HNF1A",8,4,4,0,1
"SOX10",13,5,8,0,1
"SOX8",10,5,5,0,1
"SRF",20,11,9,0,1
"CEBPE",9,5,4,0,1
"SPI1",13,8,5,0,1
"SPTBN4",7,3,4,0,1
"CGN",2,1,1,0,1
"GPS2",6,3,3,0,1
"PPP2R5A",10,6,4,0,1
"CHMP2A",3,1,2,0,1
"GZMB",5,1,4,0,1
"GPRASP1",8,2,6,0,1
"CHRNA4",3,1,2,0,1
"TANK",5,3,2,0,1
"CIB1",6,3,3,0,1
"DISC1",4,2,2,0,1
"ILK",10,8,2,0,1
"SLC9A3R1",13,6,7,0,1
"TYROBP",5,3,2,0,1
"LSM1",11,1,10,0,1
"HGS",23,10,13,0,1
"RABAC1",15,8,7,0,1
"DUSP10",4,1,3,0,1
"CNKSR1",5,3,2,0,1
"PPL",4,1,3,0,1
"RGS19",12,6,6,0,1
"COL2A1",10,6,4,0,1
"COL3A1",7,4,3,0,1
"ITGB3BP",5,3,2,0,1
"XRN2",9,4,5,0,1
"PTGES3",7,6,1,0,1
"GPS1",9,4,5,0,1
"POLDIP2",4,1,3,0,1
"MAPK11",3,2,1,0,1
"WWP1",7,4,3,0,1
"CREB3",3,1,2,0,1
"KAT2A",14,11,3,0,1
"NCOA6",13,6,7,0,1
"TP53",44,9,35,0,1
"UCN",2,1,1,0,1
"IRS1",20,14,6,0,1
"CRKL",26,10,16,0,1
"PXN",40,11,29,0,1
"RPA2",14,7,7,0,1
"GNB2L1",27,18,9,0,1
"EIF2S2",10,4,6,0,1
"UTP14A",19,7,12,0,1
"CSTF2",11,7,4,0,1
"GTF2F1",12,8,4,0,1
"SNRNP70",9,4,5,0,1
"CTGF",5,3,2,0,1
"NOV",5,3,2,0,1
"NEK1",10,8,2,0,1
"ZFYVE9",11,8,3,0,1
"CTNND2",3,1,2,0,1
"IGF1",7,5,2,0,1
"FGFR3",12,8,4,0,1
"LRP2",12,6,6,0,1
"NCF4",6,5,1,0,1
"PAFAH1B1",7,2,5,0,1
"WWP2",6,1,5,0,1
"PIK3R3",13,8,5,0,1
"LMO2",4,2,2,0,1
"MED19",3,1,2,0,1
"DDR1",3,1,2,0,1
"RGS2",21,2,19,0,1
"SORBS3",10,9,1,0,1
"SMURF2",17,8,9,0,1
"DLG1",22,1,21,0,1
"MAPK12",8,5,3,0,1
"GRIN2D",17,10,7,0,1
"DLG3",9,1,8,0,1
"PTK2B",28,10,18,0,1
"ERBB2",25,4,21,0,1
"DLST",5,3,2,0,1
"DNAJC7",6,4,2,0,1
"MPHOSPH6",5,3,2,0,1
"DOK1",10,3,7,0,1
"DPYSL2",3,2,1,0,1
"DRAP1",6,2,4,0,1
"GIPC1",12,6,6,0,1
"GNAI3",17,4,13,0,1
"NCK1",24,2,22,0,1
"MAPK14",19,13,6,0,1
"DUSP23",8,3,5,0,1
"RNPS1",5,4,1,0,1
"VDAC1",4,1,3,0,1
"TFDP1",7,5,2,0,1
"E2F2",5,2,3,0,1
"E2F3",9,4,5,0,1
"TFDP2",3,2,1,0,1
"EEF1G",23,4,19,0,1
"RHOG",6,4,2,0,1
"TRAF3",17,7,10,0,1
"GADD45A",20,12,8,0,1
"TNNT1",15,8,7,0,1
"EFNA1",4,2,2,0,1
"PPBP",4,1,3,0,1
"EFNB2",8,3,5,0,1
"HOMER1",10,4,6,0,1
"MAP2K1",20,7,13,0,1
"MAP3K14",11,6,5,0,1
"SNRPD2",6,2,4,0,1
"EIF3E",6,1,5,0,1
"POLA2",12,4,8,0,1
"MYC",18,6,12,0,1
"ID2",18,9,9,0,1
"OSGEP",9,3,6,0,1
"HK1",3,2,1,0,1
"GRIA4",4,3,1,0,1
"FLI1",7,4,3,0,1
"PIK3CB",9,6,3,0,1
"HNF4A",16,4,12,0,1
"ZBTB17",11,6,5,0,1
"MAF",3,2,1,0,1
"PFN2",7,1,6,0,1
"EXOSC6",13,2,11,0,1
"NUDT21",13,6,7,0,1
"RAB27A",8,5,3,0,1
"F10",5,2,3,0,1
"PARD3",8,3,5,0,1
"PTPRB",6,3,3,0,1
"F2",7,1,6,0,1
"PLG",8,5,3,0,1
"SNX1",6,4,2,0,1
"FAM118B",10,6,4,0,1
"RAP1A",12,5,7,0,1
"RPS6KA6",9,6,3,0,1
"FCER1G",7,1,6,0,1
"IMMT",14,2,12,0,1
"GNAQ",7,2,5,0,1
"RPS6KA3",13,6,7,0,1
"KIAA1377",22,11,11,0,1
"ICAM1",10,6,4,0,1
"PRMT1",16,8,8,0,1
"FLNB",5,3,2,0,1
"SHBG",6,2,4,0,1
"FLT3LG",2,1,1,0,1
"TGM2",11,3,8,0,1
"HRAS",28,20,8,0,1
"TBP",33,12,21,0,1
"FOXA2",5,4,1,0,1
"SMAD1",26,7,19,0,1
"FRS3",6,3,3,0,1
"ITPR1",15,5,10,0,1
"WNT4",2,1,1,0,1
"WNT1",3,2,1,0,1
"FZD9",3,1,2,0,1
"GABARAP",3,2,1,0,1
"GSK3B",38,11,27,0,1
"IARS",2,1,1,0,1
"GATA1",9,4,5,0,1
"GATA4",2,1,1,0,1
"RNF11",24,12,12,0,1
"MLNR",2,1,1,0,1
"NTRK1",14,3,11,0,1
"PLEKHF2",11,9,2,0,1
"GNB1",10,4,6,0,1
"PPP2R1A",10,7,3,0,1
"IGF1R",16,7,9,0,1
"NUDT18",12,8,4,0,1
"PLCD1",5,2,3,0,1
"GRM5",11,1,10,0,1
"TNFRSF1A",25,9,16,0,1
"NANOS1",3,2,1,0,1
"RAP2A",9,4,5,0,1
"SNCA",13,3,10,0,1
"TUBA4A",11,4,7,0,1
"MED25",7,3,4,0,1
"HDAC6",10,8,2,0,1
"ZNF512B",12,2,10,0,1
"MET",14,4,10,0,1
"HIPK3",6,3,3,0,1
"HMP19",5,1,4,0,1
"MEIS1",17,9,8,0,1
"HOXC8",4,2,2,0,1
"SMAD6",7,3,4,0,1
"PBX1",8,2,6,0,1
"HSPA5",9,2,7,0,1
"HTR1D",2,1,1,0,1
"S1PR1",4,1,3,0,1
"MPDZ",5,1,4,0,1
"HTRA1",10,1,9,0,1
"RDX",7,3,4,0,1
"TCF4",11,4,7,0,1
"UBE2D3",8,6,2,0,1
"IL4R",7,1,6,0,1
"IL18",4,2,2,0,1
"IL1RAP",7,3,4,0,1
"TOLLIP",9,5,4,0,1
"SIRPA",3,2,1,0,1
"SDC1",4,1,3,0,1
"MRPL44",8,5,3,0,1
"NEK2",7,2,5,0,1
"TRAF4",13,8,5,0,1
"IRF8",8,3,5,0,1
"ITFG1",4,2,2,0,1
"TLN1",10,5,5,0,1
"RNF7",4,1,3,0,1
"PRKG1",14,6,8,0,1
"TRPC6",3,1,2,0,1
"PTPN6",32,4,28,0,1
"TJP1",11,2,9,0,1
"WDYHV1",10,4,6,0,1
"KIAA1279",3,1,2,0,1
"KRT18",10,5,5,0,1
"PRKAA2",2,1,1,0,1
"SNX4",7,4,3,0,1
"NGFR",17,5,12,0,1
"SHANK2",8,3,5,0,1
"SHANK1",10,2,8,0,1
"LSM5",6,4,2,0,1
"LSM7",2,1,1,0,1
"MACF1",4,2,2,0,1
"MAD1L1",8,7,1,0,1
"NDC80",12,5,7,0,1
"MAFK",2,1,1,0,1
"MBP",10,3,7,0,1
"MAGEA4",2,1,1,0,1
"MAP1B",8,2,6,0,1
"MAP2K6",9,5,4,0,1
"MAP2K7",6,4,2,0,1
"TNIP2",5,3,2,0,1
"MAPK8IP2",8,3,5,0,1
"MAPK8IP3",16,5,11,0,1
"UFD1L",3,2,1,0,1
"SMAD5",13,4,9,0,1
"SMAD7",7,2,5,0,1
"ZMYND19",4,1,3,0,1
"MECP2",7,3,4,0,1
"MED9",8,4,4,0,1
"MED17",4,2,2,0,1
"MED22",3,1,2,0,1
"MEF2C",7,3,4,0,1
"MEOX1",3,2,1,0,1
"MINK1",4,1,3,0,1
"MSX1",8,3,5,0,1
"NEDD8",4,2,2,0,1
"NAPA",6,2,4,0,1
"NCAN",4,3,1,0,1
"RXRB",11,7,4,0,1
"TSC22D1",4,2,2,0,1
"NDEL1",5,2,3,0,1
"PHYHIP",7,3,4,0,1
"NFIC",3,2,1,0,1
"NFKB2",10,4,6,0,1
"NFKBIB",12,6,6,0,1
"NR5A1",7,2,5,0,1
"NFYA",6,3,3,0,1
"TRAF5",13,7,6,0,1
"RPGR",3,1,2,0,1
"NR3C1",21,3,18,0,1
"NR4A1",8,1,7,0,1
"PROX1",4,2,2,0,1
"STX8",5,3,2,0,1
"NTF3",2,1,1,0,1
"PTGS2",2,1,1,0,1
"OPRD1",8,2,6,0,1
"PTN",11,4,7,0,1
"PAX6",2,1,1,0,1
"SIX3",2,1,1,0,1
"PCM1",4,1,3,0,1
"PDE6D",10,1,9,0,1
"RAB8A",4,2,2,0,1
"PDGFRB",20,3,17,0,1
"TUBG1",9,5,4,0,1
"SH3GL1",8,3,5,0,1
"PIP4K2A",2,1,1,0,1
"PIP4K2C",4,1,3,0,1
"TRPC3",4,2,2,0,1
"VAV3",9,3,6,0,1
"UBAP2L",3,1,2,0,1
"PNN",6,2,4,0,1
"POLR3F",5,2,3,0,1
"PPFIBP2",4,2,2,0,1
"TSG101",6,2,4,0,1
"RCVRN",2,1,1,0,1
"PSMD4",2,1,1,0,1
"PTGDS",5,2,3,0,1
"RBM8A",3,1,2,0,1
"RCOR1",3,2,1,0,1
"RLN3",2,1,1,0,1
"UBE2L6",5,2,3,0,1
"SERPING1",4,1,3,0,1
"TRIM2",2,1,1,0,1
"SOX5",3,2,1,0,1
"SMARCC1",4,1,3,0,1
"SMG1",4,2,2,0,1
"STX11",5,3,2,0,1
"SNAP25",2,1,1,0,1
"SOX6",2,1,1,0,1
"TES",5,2,3,0,1
"SST",4,2,2,0,1
"SSTR5",3,1,2,0,1
"STX3",3,1,2,0,1
"SYT4",3,1,2,0,1
"TARBP2",3,1,2,0,1
"TLR1",6,1,5,0,1
"TNFRSF10B",4,1,3,0,1
"TNFRSF4",6,1,5,0,1
"ZNF446",3,1,2,0,1
